models,model_rounds,validation_accuracy,validation_lower_bound,validation_upper_bound,validation_total,validation_correct,test_accuracy,test_lower_bound,test_upper_bound,test_total,test_correct,validation_TP,test_TP,validation_FP,test_FP,validation_TN,test_TN,validation_FN,test_FN
"sgc_coral-anthropic3710,sgc_coral-gemini2510,sgc_coral-openailong","3,2,3",0.7115384615384616,0.6144665882968031,0.7961807727800615,104,74,0.5929203539823009,0.4964726470054805,0.6843740416228519,113,67,45,52,13,10,29,15,17,36
"sgc_coral-anthropic3710,sgc_coral-gemini2510,sgc_coral-gemma","3,2,1",0.7115384615384616,0.6144665882968031,0.7961807727800615,104,74,0.6283185840707964,0.5323652037350549,0.717368992019971,113,71,46,58,14,12,28,13,16,30
"sgc_coral-anthropic3710,sgc_coral-openai10,sgc_coral-openailong","3,1,3",0.7019230769230769,0.6043189953791482,0.7876696623710339,104,73,0.5752212389380531,0.4787054077974483,0.6676956871258655,113,65,43,47,12,7,30,18,19,41
"sgc_coral-anthropic37,sgc_coral-anthropic3710,sgc_coral-gemini2510","7,3,2",0.7019230769230769,0.6043189953791482,0.7876696623710339,104,73,0.5663716814159292,0.4698655764900294,0.6593123718320077,113,64,40,46,9,7,33,18,22,42
"sgc_coral-geminipro10,sgc_coral-openai10,sgc_coral-openailong","1,1,3",0.7019230769230769,0.6043189953791482,0.7876696623710339,104,73,0.48672566371681414,0.391592485688175,0.5825715848269355,113,55,41,39,10,9,32,16,21,49
"sgc_coral-anthropic3710,sgc_coral-openai45,sgc_coral-openailong","3,1,3",0.6923076923076923,0.5942159847050734,0.7791128107798506,104,72,0.6371681415929203,0.5414149629210798,0.7255401401231517,113,72,43,54,13,7,29,18,19,34
"sgc_coral-anthropic3710,sgc_coral-geminipro,sgc_coral-openailong","3,1,3",0.6923076923076923,0.5942159847050734,0.7791128107798506,104,72,0.5575221238938053,0.4610546518661339,0.6508999553070312,113,63,44,46,14,8,28,17,18,42
"sgc_coral-anthropic3710,sgc_coral-gemini2510,sgc_coral-openai10","3,2,1",0.6923076923076923,0.5942159847050734,0.7791128107798506,104,72,0.6283185840707964,0.5323652037350549,0.717368992019971,113,71,48,56,18,10,24,15,14,32
"sgc_coral-anthropic3710,sgc_coral-gemini2510,sgc_coral-openai45","3,2,1",0.6923076923076923,0.5942159847050734,0.7791128107798506,104,72,0.6637168141592921,0.5687552162567255,0.7498596396389975,113,75,47,60,17,10,25,15,15,28
"sgc_coral-anthropic3710,sgc_coral-gemini2510,sgc_coral-openaio1","3,2,2",0.6826923076923077,0.5841564236958328,0.7705114525244577,104,71,0.6283185840707964,0.5323652037350549,0.717368992019971,113,71,41,54,12,8,30,17,21,34
"sgc_coral-anthropic3710,sgc_coral-geminipro10,sgc_coral-openailong","3,1,3",0.6826923076923077,0.5841564236958328,0.7705114525244577,104,71,0.5752212389380531,0.4787054077974483,0.6676956871258655,113,65,42,48,13,8,29,17,20,40
"sgc_coral-gemini2510,sgc_coral-openai10,sgc_coral-openailong","2,1,3",0.6826923076923077,0.5841564236958328,0.7705114525244577,104,71,0.5929203539823009,0.4964726470054805,0.6843740416228519,113,67,46,51,17,9,25,16,16,37
"sgc_coral-gemini2510,sgc_coral-geminipro,sgc_coral-openailong","2,1,3",0.6826923076923077,0.5841564236958328,0.7705114525244577,104,71,0.6194690265486725,0.5233464844783339,0.7091663790724447,113,70,45,54,16,9,26,16,17,34
"sgc_coral-anthropic37,sgc_coral-gemini2510,sgc_coral-openailong","7,2,3",0.6826923076923077,0.5841564236958328,0.7705114525244577,104,71,0.5663716814159292,0.4698655764900294,0.6593123718320077,113,64,40,47,11,8,31,17,22,41
"sgc_coral-anthropic3710,sgc_coral-openai,sgc_coral-openailong","3,1,3",0.6826923076923077,0.5841564236958328,0.7705114525244577,104,71,0.5752212389380531,0.4787054077974483,0.6676956871258655,113,65,41,46,12,6,30,19,21,42
"sgc_coral-anthropic10,sgc_coral-anthropic37,sgc_coral-gemini2510","4,7,2",0.6826923076923077,0.5841564236958328,0.7705114525244577,104,71,0.5221238938053098,0.4260969019985035,0.6169629390023114,113,59,36,41,7,7,35,18,26,47
"sgc_coral-anthropic3710,sgc_coral-gemini2510,sgc_coral-geminipro","3,2,1",0.6826923076923077,0.5841564236958328,0.7705114525244577,104,71,0.6194690265486725,0.5233464844783339,0.7091663790724447,113,70,46,56,17,11,25,14,16,32
"sgc_coral-anthropic10,sgc_coral-gemini2510,sgc_coral-geminipro","4,2,1",0.6730769230769231,0.5741392800895302,0.7618667125500935,104,70,0.5575221238938053,0.4610546518661339,0.6508999553070312,113,63,41,47,13,9,29,16,21,41
"sgc_coral-anthropic3710,sgc_coral-gemma,sgc_coral-openai10","3,1,1",0.6730769230769231,0.5741392800895302,0.7618667125500935,104,70,0.5486725663716814,0.4522724568103532,0.642458642416372,113,62,45,47,17,10,25,15,17,41
"sgc_coral-anthropic10,sgc_coral-anthropic3710,sgc_coral-gemini2510","4,3,2",0.6730769230769231,0.5741392800895302,0.7618667125500935,104,70,0.5663716814159292,0.4698655764900294,0.6593123718320077,113,64,39,48,11,9,31,16,23,40
"sgc_coral-anthropic3710,sgc_coral-gemini2510,sgc_coral-geminipro10","3,2,1",0.6730769230769231,0.5741392800895302,0.7618667125500935,104,70,0.5929203539823009,0.4964726470054805,0.6843740416228519,113,67,45,54,17,12,25,13,17,34
"sgc_coral-anthropic3710,sgc_coral-gemini25,sgc_coral-gemini2510","3,2,2",0.6730769230769231,0.5741392800895302,0.7618667125500935,104,70,0.5309734513274337,0.4347936889763754,0.6254900011303783,113,60,38,43,10,8,32,17,24,45
"sgc_coral-openai10,sgc_coral-openai4510,sgc_coral-openailong","1,1,3",0.6730769230769231,0.5741392800895302,0.7618667125500935,104,70,0.5575221238938053,0.4610546518661339,0.6508999553070312,113,63,42,45,14,7,28,18,20,43
"sgc_coral-anthropic37,sgc_coral-anthropic3710,sgc_coral-openailong","7,3,3",0.6730769230769231,0.5741392800895302,0.7618667125500935,104,70,0.5221238938053098,0.4260969019985035,0.6169629390023114,113,59,35,39,7,5,35,20,27,49
"sgc_coral-anthropic3710,sgc_coral-gemini10,sgc_coral-gemini2510","3,4,2",0.6730769230769231,0.5741392800895302,0.7618667125500935,104,70,0.5486725663716814,0.4522724568103532,0.642458642416372,113,62,38,45,10,8,32,17,24,43
"sgc_coral-anthropic,sgc_coral-gemini2510,sgc_coral-openailong","1,2,3",0.6730769230769231,0.5741392800895302,0.7618667125500935,104,70,0.5663716814159292,0.4698655764900294,0.6593123718320077,113,64,45,48,17,9,25,16,17,40
"sgc_coral-anthropic10,sgc_coral-geminipro10,sgc_coral-openai10","4,1,1",0.6730769230769231,0.5741392800895302,0.7618667125500935,104,70,0.4247787610619469,0.33230431287413453,0.5212945922025517,113,48,34,31,6,8,36,17,28,57
"sgc_coral-gemini2510,sgc_coral-openai10,sgc_coral-openaio1","2,1,2",0.6730769230769231,0.5741392800895302,0.7618667125500935,104,70,0.6106194690265486,0.5143583942222505,0.7009327503651719,113,69,42,52,14,8,28,17,20,36
"sgc_coral-anthropic37,sgc_coral-anthropic3710,sgc_coral-geminipro","7,3,1",0.6730769230769231,0.5741392800895302,0.7618667125500935,104,70,0.4778761061946903,0.38303706099768864,0.5739030980014965,113,54,36,35,8,6,34,19,26,53
"sgc_coral-geminipro,sgc_coral-geminipro10,sgc_coral-openailong","1,1,3",0.6634615384615384,0.5641636130662238,0.7531796163162903,104,69,0.49557522123893805,0.40017620771878704,0.5912118116445175,113,56,40,42,13,11,29,14,22,46
"sgc_coral-anthropic,sgc_coral-openai10,sgc_coral-openailong","1,1,3",0.6634615384615384,0.5641636130662238,0.7531796163162903,104,69,0.504424778761062,0.4087881883554824,0.599823792281213,113,57,44,41,17,9,25,16,18,47
"sgc_coral-gemini,sgc_coral-gemini2510,sgc_coral-openailong","1,2,3",0.6634615384615384,0.5641636130662238,0.7531796163162903,104,69,0.6017699115044248,0.5054005604480631,0.6926685144473006,113,68,45,52,18,9,24,16,17,36
"sgc_coral-gemini2510,sgc_coral-geminipro,sgc_coral-geminipro10","2,1,1",0.6634615384615384,0.5641636130662238,0.7531796163162903,104,69,0.5752212389380531,0.4787054077974483,0.6676956871258655,113,65,45,52,18,12,24,13,17,36
"sgc_coral-gemini2510,sgc_coral-geminipro10,sgc_coral-openai10","2,1,1",0.6634615384615384,0.5641636130662238,0.7531796163162903,104,69,0.5398230088495575,0.44351884275715087,0.6339886086814048,113,61,47,48,20,12,22,13,15,40
"sgc_coral-anthropic3710,sgc_coral-geminipro10,sgc_coral-openai10","3,1,1",0.6634615384615384,0.5641636130662238,0.7531796163162903,104,69,0.4690265486725664,0.3745099988696216,0.5652063110236246,113,53,40,40,13,12,29,13,22,48
"sgc_coral-anthropic3710,sgc_coral-openailong,sgc_coral-openaio1","3,3,2",0.6634615384615384,0.5641636130662238,0.7531796163162903,104,69,0.6017699115044248,0.5054005604480631,0.6926685144473006,113,68,36,48,9,5,33,20,26,40
"sgc_coral-gemini2510,sgc_coral-geminipro10,sgc_coral-openailong","2,1,3",0.6634615384615384,0.5641636130662238,0.7531796163162903,104,69,0.5929203539823009,0.4964726470054805,0.6843740416228519,113,67,42,52,15,10,27,15,20,36
"sgc_coral-anthropic37,sgc_coral-geminipro10,sgc_coral-openai10","7,1,1",0.6634615384615384,0.5641636130662238,0.7531796163162903,104,69,0.46017699115044247,0.3660113913185952,0.5564811572428492,113,52,33,33,6,6,36,19,29,55
"sgc_coral-anthropic10,sgc_coral-openai10,sgc_coral-openailong","4,1,3",0.6634615384615384,0.5641636130662238,0.7531796163162903,104,69,0.5132743362831859,0.41742841517306456,0.608407514311825,113,58,35,38,8,5,34,20,27,50
"sgc_coral-gemini2510,sgc_coral-gemma,sgc_coral-openailong","2,1,3",0.6634615384615384,0.5641636130662238,0.7531796163162903,104,69,0.6460176991150443,0.5504962136889733,0.7336793311699545,113,73,43,58,16,10,26,15,19,30
"sgc_coral-anthropic3710,sgc_coral-gemini,sgc_coral-openai10","3,1,1",0.6634615384615384,0.5641636130662238,0.7531796163162903,104,69,0.5752212389380531,0.4787054077974483,0.6676956871258655,113,65,45,50,18,10,24,15,17,38
"sgc_coral-anthropic3710,sgc_coral-gemini,sgc_coral-openailong","3,1,3",0.6634615384615384,0.5641636130662238,0.7531796163162903,104,69,0.5309734513274337,0.4347936889763754,0.6254900011303783,113,60,42,44,15,9,27,16,20,44
"sgc_coral-openai10,sgc_coral-openailong,sgc_coral-openaio1","1,3,2",0.6634615384615384,0.5641636130662238,0.7531796163162903,104,69,0.5486725663716814,0.4522724568103532,0.642458642416372,113,62,36,43,9,6,33,19,26,45
"sgc_coral-anthropic10,sgc_coral-gemini2510,sgc_coral-openailong","4,2,3",0.6634615384615384,0.5641636130662238,0.7531796163162903,104,69,0.5575221238938053,0.4610546518661339,0.6508999553070312,113,63,38,46,11,8,31,17,24,42
"sgc_coral-anthropic10,sgc_coral-gemini2510,sgc_coral-openai10","4,2,1",0.6634615384615384,0.5641636130662238,0.7531796163162903,104,69,0.6017699115044248,0.5054005604480631,0.6926685144473006,113,68,41,51,14,8,28,17,21,37
"sgc_coral-anthropic37,sgc_coral-gemini2510,sgc_coral-openai10","7,2,1",0.6538461538461539,0.5542285655278716,0.744451098551687,104,68,0.5309734513274337,0.4347936889763754,0.6254900011303783,113,60,40,40,14,5,28,20,22,48
"sgc_coral-anthropic37,sgc_coral-gemini2510,sgc_coral-geminipro","7,2,1",0.6538461538461539,0.5542285655278716,0.744451098551687,104,68,0.5486725663716814,0.4522724568103532,0.642458642416372,113,62,38,45,12,8,30,17,24,43
"sgc_coral-anthropic37,sgc_coral-gemini2510,sgc_coral-openaio1","7,2,2",0.6538461538461539,0.5542285655278716,0.744451098551687,104,68,0.5132743362831859,0.41742841517306456,0.608407514311825,113,58,33,38,7,5,35,20,29,50
"sgc_coral-anthropic37,sgc_coral-openai10,sgc_coral-openailong","7,1,3",0.6538461538461539,0.5542285655278716,0.744451098551687,104,68,0.48672566371681414,0.391592485688175,0.5825715848269355,113,55,34,34,8,4,34,21,28,54
"sgc_coral-gemini10,sgc_coral-gemini2510,sgc_coral-openailong","4,2,3",0.6538461538461539,0.5542285655278716,0.744451098551687,104,68,0.504424778761062,0.4087881883554824,0.599823792281213,113,57,37,40,11,8,31,17,25,48
"sgc_coral-anthropic10,sgc_coral-gemini2510,sgc_coral-openai45","4,2,1",0.6538461538461539,0.5542285655278716,0.744451098551687,104,68,0.5752212389380531,0.4787054077974483,0.6676956871258655,113,65,38,48,12,8,30,17,24,40
"sgc_coral-anthropic10,sgc_coral-anthropic37,sgc_coral-anthropic3710","4,7,3",0.6538461538461539,0.5542285655278716,0.744451098551687,104,68,0.4690265486725664,0.3745099988696216,0.5652063110236246,113,53,31,33,5,5,37,20,31,55
"sgc_coral-anthropic37,sgc_coral-gemini,sgc_coral-gemini2510","7,1,2",0.6538461538461539,0.5542285655278716,0.744451098551687,104,68,0.5398230088495575,0.44351884275715087,0.6339886086814048,113,61,41,43,15,7,27,18,21,45
"sgc_coral-anthropic3710,sgc_coral-openai10o1,sgc_coral-openailong","3,1,3",0.6538461538461539,0.5542285655278716,0.744451098551687,104,68,0.5221238938053098,0.4260969019985035,0.6169629390023114,113,59,37,44,11,10,31,15,25,44
"sgc_coral-anthropic10,sgc_coral-gemini2510,sgc_coral-geminipro10","4,2,1",0.6538461538461539,0.5542285655278716,0.744451098551687,104,68,0.5398230088495575,0.44351884275715087,0.6339886086814048,113,61,38,46,12,10,30,15,24,42
"sgc_coral-anthropic10,sgc_coral-anthropic37,sgc_coral-openai10","4,7,1",0.6538461538461539,0.5542285655278716,0.744451098551687,104,68,0.39823008849557523,0.30733148555269946,0.4945994395519369,113,45,31,24,5,4,37,21,31,64
"sgc_coral-anthropic3710,sgc_coral-openai10,sgc_coral-openai10o1","3,1,1",0.6538461538461539,0.5542285655278716,0.744451098551687,104,68,0.49557522123893805,0.40017620771878704,0.5912118116445175,113,56,44,41,18,10,24,15,18,47
"sgc_coral-anthropic3710,sgc_coral-gemini2510,sgc_coral-openai","3,2,1",0.6538461538461539,0.5542285655278716,0.744451098551687,104,68,0.6371681415929203,0.5414149629210798,0.7255401401231517,113,72,43,56,17,9,25,16,19,32
"sgc_coral-anthropic10,sgc_coral-anthropic3710,sgc_coral-geminipro10","4,3,1",0.6538461538461539,0.5542285655278716,0.744451098551687,104,68,0.4778761061946903,0.38303706099768864,0.5739030980014965,113,54,34,38,8,9,34,16,28,50
"sgc_coral-anthropic37,sgc_coral-gemini2510,sgc_coral-openai45","7,2,1",0.6538461538461539,0.5542285655278716,0.744451098551687,104,68,0.5929203539823009,0.4964726470054805,0.6843740416228519,113,67,37,48,11,6,31,19,25,40
"sgc_coral-anthropic3710,sgc_coral-gemini2510,sgc_coral-openai4510","3,2,1",0.6538461538461539,0.5542285655278716,0.744451098551687,104,68,0.6371681415929203,0.5414149629210798,0.7255401401231517,113,72,43,55,17,8,25,17,19,33
"sgc_coral-anthropic10,sgc_coral-gemini,sgc_coral-gemini2510","4,1,2",0.6538461538461539,0.5542285655278716,0.744451098551687,104,68,0.5663716814159292,0.4698655764900294,0.6593123718320077,113,64,41,47,15,8,27,17,21,41
"sgc_coral-anthropic3710,sgc_coral-geminipro,sgc_coral-openai10","3,1,1",0.6538461538461539,0.5542285655278716,0.744451098551687,104,68,0.5309734513274337,0.4347936889763754,0.6254900011303783,113,60,44,46,18,11,24,14,18,42
"sgc_coral-anthropic37,sgc_coral-gemini10,sgc_coral-gemini2510","7,4,2",0.6538461538461539,0.5542285655278716,0.744451098551687,104,68,0.45132743362831856,0.35754135758362804,0.5477275431896468,113,51,33,32,7,6,35,19,29,56
"sgc_coral-anthropic,sgc_coral-anthropic3710,sgc_coral-gemini2510","1,3,2",0.6538461538461539,0.5542285655278716,0.744451098551687,104,68,0.6283185840707964,0.5323652037350549,0.717368992019971,113,71,46,58,20,12,22,13,16,30
"sgc_coral-gemini2510,sgc_coral-openai45,sgc_coral-openailong","2,1,3",0.6538461538461539,0.5542285655278716,0.744451098551687,104,68,0.6194690265486725,0.5233464844783339,0.7091663790724447,113,70,43,54,17,9,25,16,19,34
"sgc_coral-gemini2510,sgc_coral-openai10o1,sgc_coral-openai45","2,1,1",0.6538461538461539,0.5542285655278716,0.744451098551687,104,68,0.6017699115044248,0.5054005604480631,0.6926685144473006,113,68,44,55,18,12,24,13,18,33
"sgc_coral-anthropic,sgc_coral-anthropic3710,sgc_coral-openai10","1,3,1",0.6538461538461539,0.5542285655278716,0.744451098551687,104,68,0.5309734513274337,0.4347936889763754,0.6254900011303783,113,60,43,44,17,9,25,16,19,44
"sgc_coral-anthropic,sgc_coral-anthropic10,sgc_coral-gemini2510","1,4,2",0.6538461538461539,0.5542285655278716,0.744451098551687,104,68,0.5575221238938053,0.4610546518661339,0.6508999553070312,113,63,40,48,14,10,28,15,22,40
"sgc_coral-anthropic,sgc_coral-anthropic3710,sgc_coral-geminipro10","1,3,1",0.6538461538461539,0.5542285655278716,0.744451098551687,104,68,0.504424778761062,0.4087881883554824,0.599823792281213,113,57,42,41,16,9,26,16,20,47
"sgc_coral-gemini2510,sgc_coral-openai10,sgc_coral-openai4510","2,1,1",0.6538461538461539,0.5542285655278716,0.744451098551687,104,68,0.6106194690265486,0.5143583942222505,0.7009327503651719,113,69,46,55,20,11,22,14,16,33
"sgc_coral-gemini2510,sgc_coral-openailong,sgc_coral-openaio1","2,3,2",0.6538461538461539,0.5542285655278716,0.744451098551687,104,68,0.6017699115044248,0.5054005604480631,0.6926685144473006,113,68,38,50,12,7,30,18,24,38
"sgc_coral-gemma,sgc_coral-openai10,sgc_coral-openailong","1,1,3",0.6538461538461539,0.5542285655278716,0.744451098551687,104,68,0.5486725663716814,0.4522724568103532,0.642458642416372,113,62,44,46,18,9,24,16,18,42
"sgc_coral-anthropic,sgc_coral-anthropic3710,sgc_coral-openailong","1,3,3",0.6538461538461539,0.5542285655278716,0.744451098551687,104,68,0.5486725663716814,0.4522724568103532,0.642458642416372,113,62,40,46,14,9,28,16,22,42
"sgc_coral-gemini2510,sgc_coral-openai10,sgc_coral-openai10o1","2,1,1",0.6538461538461539,0.5542285655278716,0.744451098551687,104,68,0.5752212389380531,0.4787054077974483,0.6676956871258655,113,65,47,51,21,11,21,14,15,37
"sgc_coral-anthropic3710,sgc_coral-geminipro10,sgc_coral-openai10o1","3,1,1",0.6442307692307693,0.5443333573674021,0.7356820108733471,104,67,0.45132743362831856,0.35754135758362804,0.5477275431896468,113,51,40,38,15,12,27,13,22,50
"sgc_coral-openai10,sgc_coral-openai10o1,sgc_coral-openailong","1,1,3",0.6442307692307693,0.5443333573674021,0.7356820108733471,104,67,0.49557522123893805,0.40017620771878704,0.5912118116445175,113,56,40,40,15,9,27,16,22,48
"sgc_coral-anthropic10,sgc_coral-gemini2510,sgc_coral-openaio1","4,2,2",0.6442307692307693,0.5443333573674021,0.7356820108733471,104,67,0.5575221238938053,0.4610546518661339,0.6508999553070312,113,63,33,45,8,7,34,18,29,43
"sgc_coral-anthropic10,sgc_coral-openai45,sgc_coral-openailong","4,1,3",0.6442307692307693,0.5443333573674021,0.7356820108733471,104,67,0.5132743362831859,0.41742841517306456,0.608407514311825,113,58,33,40,8,7,34,18,29,48
"sgc_coral-anthropic,sgc_coral-gemma,sgc_coral-openailong","1,1,3",0.6442307692307693,0.5443333573674021,0.7356820108733471,104,67,0.5663716814159292,0.4698655764900294,0.6593123718320077,113,64,40,50,15,11,27,14,22,38
"sgc_coral-anthropic3710,sgc_coral-openai4510,sgc_coral-openailong","3,1,3",0.6442307692307693,0.5443333573674021,0.7356820108733471,104,67,0.5486725663716814,0.4522724568103532,0.642458642416372,113,62,36,44,11,7,31,18,26,44
"sgc_coral-gemini10,sgc_coral-geminipro10,sgc_coral-openai10","4,1,1",0.6442307692307693,0.5443333573674021,0.7356820108733471,104,67,0.3805309734513274,0.2908336209275553,0.4766535155216661,113,43,31,25,6,7,36,18,31,63
"sgc_coral-gemini25,sgc_coral-gemini2510,sgc_coral-openai10","2,2,1",0.6442307692307693,0.5443333573674021,0.7356820108733471,104,67,0.49557522123893805,0.40017620771878704,0.5912118116445175,113,56,38,37,13,6,29,19,24,51
"sgc_coral-anthropic3710,sgc_coral-gemini25,sgc_coral-openailong","3,2,3",0.6442307692307693,0.5443333573674021,0.7356820108733471,104,67,0.4778761061946903,0.38303706099768864,0.5739030980014965,113,54,33,34,8,5,34,20,29,54
"sgc_coral-anthropic37,sgc_coral-openai45,sgc_coral-openailong","7,1,3",0.6442307692307693,0.5443333573674021,0.7356820108733471,104,67,0.5221238938053098,0.4260969019985035,0.6169629390023114,113,59,32,37,7,3,35,22,30,51
"sgc_coral-anthropic37,sgc_coral-anthropic3710,sgc_coral-gemini","7,3,1",0.6442307692307693,0.5443333573674021,0.7356820108733471,104,67,0.49557522123893805,0.40017620771878704,0.5912118116445175,113,56,35,39,10,8,32,17,27,49
"sgc_coral-anthropic,sgc_coral-anthropic3710,sgc_coral-gemini","1,3,1",0.6442307692307693,0.5443333573674021,0.7356820108733471,104,67,0.5752212389380531,0.4787054077974483,0.6676956871258655,113,65,43,49,18,9,24,16,19,39
"sgc_coral-geminipro10,sgc_coral-openai4510,sgc_coral-openailong","1,1,3",0.6442307692307693,0.5443333573674021,0.7356820108733471,104,67,0.4778761061946903,0.38303706099768864,0.5739030980014965,113,54,37,39,12,10,30,15,25,49
"sgc_coral-gemini2510,sgc_coral-openai,sgc_coral-openailong","2,1,3",0.6442307692307693,0.5443333573674021,0.7356820108733471,104,67,0.6017699115044248,0.5054005604480631,0.6926685144473006,113,68,41,52,16,9,26,16,21,36
"sgc_coral-openai10,sgc_coral-openai45,sgc_coral-openailong","1,1,3",0.6442307692307693,0.5443333573674021,0.7356820108733471,104,67,0.5752212389380531,0.4787054077974483,0.6676956871258655,113,65,42,49,17,9,25,16,20,39
"sgc_coral-openai45,sgc_coral-openai4510,sgc_coral-openailong","1,1,3",0.6442307692307693,0.5443333573674021,0.7356820108733471,104,67,0.5929203539823009,0.4964726470054805,0.6843740416228519,113,67,39,53,14,11,28,14,23,35
"sgc_coral-anthropic,sgc_coral-anthropic10,sgc_coral-openai10","1,4,1",0.6442307692307693,0.5443333573674021,0.7356820108733471,104,67,0.504424778761062,0.4087881883554824,0.599823792281213,113,57,38,39,13,7,29,18,24,49
"sgc_coral-anthropic37,sgc_coral-gemini25,sgc_coral-gemini2510","7,2,2",0.6442307692307693,0.5443333573674021,0.7356820108733471,104,67,0.45132743362831856,0.35754135758362804,0.5477275431896468,113,51,32,29,7,3,35,22,30,59
"sgc_coral-gemini2510,sgc_coral-openai,sgc_coral-openai10","2,1,1",0.6442307692307693,0.5443333573674021,0.7356820108733471,104,67,0.5929203539823009,0.4964726470054805,0.6843740416228519,113,67,45,51,20,9,22,16,17,37
"sgc_coral-anthropic3710,sgc_coral-gemma,sgc_coral-openailong","3,1,3",0.6442307692307693,0.5443333573674021,0.7356820108733471,104,67,0.5575221238938053,0.4610546518661339,0.6508999553070312,113,63,38,48,13,10,29,15,24,40
"sgc_coral-anthropic10,sgc_coral-anthropic3710,sgc_coral-geminipro","4,3,1",0.6442307692307693,0.5443333573674021,0.7356820108733471,104,67,0.504424778761062,0.4087881883554824,0.599823792281213,113,57,34,41,9,9,33,16,28,47
"sgc_coral-gemini2510,sgc_coral-geminipro10,sgc_coral-openai4510","2,1,1",0.6442307692307693,0.5443333573674021,0.7356820108733471,104,67,0.5486725663716814,0.4522724568103532,0.642458642416372,113,62,41,50,16,13,26,12,21,38
"sgc_coral-anthropic37,sgc_coral-gemini2510,sgc_coral-openai","7,2,1",0.6442307692307693,0.5443333573674021,0.7356820108733471,104,67,0.5309734513274337,0.4347936889763754,0.6254900011303783,113,60,37,41,12,6,30,19,25,47
"sgc_coral-gemini2510,sgc_coral-geminipro10,sgc_coral-openai10o1","2,1,1",0.6442307692307693,0.5443333573674021,0.7356820108733471,104,67,0.5132743362831859,0.41742841517306456,0.608407514311825,113,58,42,46,17,13,25,12,20,42
"sgc_coral-anthropic10,sgc_coral-anthropic3710,sgc_coral-openailong","4,3,3",0.6442307692307693,0.5443333573674021,0.7356820108733471,104,67,0.5132743362831859,0.41742841517306456,0.608407514311825,113,58,34,40,9,7,33,18,28,48
"sgc_coral-anthropic10,sgc_coral-anthropic3710,sgc_coral-openai10","4,3,1",0.6442307692307693,0.5443333573674021,0.7356820108733471,104,67,0.5575221238938053,0.4610546518661339,0.6508999553070312,113,63,36,45,11,7,31,18,26,43
"sgc_coral-anthropic10,sgc_coral-gemini2510,sgc_coral-gemma","4,2,1",0.6442307692307693,0.5443333573674021,0.7356820108733471,104,67,0.584070796460177,0.4875743523159756,0.6760496659713334,113,66,36,49,11,8,31,17,26,39
"sgc_coral-anthropic3710,sgc_coral-openai10,sgc_coral-openaio1","3,1,2",0.6442307692307693,0.5443333573674021,0.7356820108733471,104,67,0.5929203539823009,0.4964726470054805,0.6843740416228519,113,67,37,48,12,6,30,19,25,40
"sgc_coral-anthropic37,sgc_coral-anthropic3710,sgc_coral-openai45","7,3,1",0.6442307692307693,0.5443333573674021,0.7356820108733471,104,67,0.5132743362831859,0.41742841517306456,0.608407514311825,113,58,34,40,9,7,33,18,28,48
"sgc_coral-gemini2510,sgc_coral-geminipro,sgc_coral-openai10","2,1,1",0.6442307692307693,0.5443333573674021,0.7356820108733471,104,67,0.5752212389380531,0.4787054077974483,0.6676956871258655,113,65,46,50,21,10,21,15,16,38
"sgc_coral-anthropic37,sgc_coral-anthropic3710,sgc_coral-openai10","7,3,1",0.6442307692307693,0.5443333573674021,0.7356820108733471,104,67,0.48672566371681414,0.391592485688175,0.5825715848269355,113,55,36,34,11,4,31,21,26,54
"sgc_coral-anthropic37,sgc_coral-anthropic3710,sgc_coral-geminipro10","7,3,1",0.6442307692307693,0.5443333573674021,0.7356820108733471,104,67,0.4778761061946903,0.38303706099768864,0.5739030980014965,113,54,33,35,8,6,34,19,29,53
"sgc_coral-anthropic,sgc_coral-anthropic3710,sgc_coral-gemma","1,3,1",0.6346153846153846,0.5344772795898101,0.7268731284326717,104,66,0.5398230088495575,0.44351884275715087,0.6339886086814048,113,61,44,50,20,14,22,11,18,38
"sgc_coral-anthropic3710,sgc_coral-geminipro10,sgc_coral-openai","3,1,1",0.6346153846153846,0.5344772795898101,0.7268731284326717,104,66,0.49557522123893805,0.40017620771878704,0.5912118116445175,113,56,38,42,14,11,28,14,24,46
"sgc_coral-anthropic3710,sgc_coral-gemini2510,sgc_coral-openai10o1","3,2,1",0.6346153846153846,0.5344772795898101,0.7268731284326717,104,66,0.5663716814159292,0.4698655764900294,0.6593123718320077,113,64,43,52,19,13,23,12,19,36
"sgc_coral-anthropic3710,sgc_coral-openai45,sgc_coral-openaio1","3,1,2",0.6346153846153846,0.5344772795898101,0.7268731284326717,104,66,0.5929203539823009,0.4964726470054805,0.6843740416228519,113,67,35,49,11,7,31,18,27,39
"sgc_coral-anthropic3710,sgc_coral-openai10,sgc_coral-openai4510","3,1,1",0.6346153846153846,0.5344772795898101,0.7268731284326717,104,66,0.5132743362831859,0.41742841517306456,0.608407514311825,113,58,41,44,17,11,25,14,21,44
"sgc_coral-anthropic3710,sgc_coral-openai10,sgc_coral-openai45","3,1,1",0.6346153846153846,0.5344772795898101,0.7268731284326717,104,66,0.5309734513274337,0.4347936889763754,0.6254900011303783,113,60,40,48,16,13,26,12,22,40
"sgc_coral-anthropic3710,sgc_coral-gemini25,sgc_coral-openai45","3,2,1",0.6346153846153846,0.5344772795898101,0.7268731284326717,104,66,0.5132743362831859,0.41742841517306456,0.608407514311825,113,58,33,39,9,6,33,19,29,49
"sgc_coral-anthropic10,sgc_coral-anthropic3710,sgc_coral-openai45","4,3,1",0.6346153846153846,0.5344772795898101,0.7268731284326717,104,66,0.5663716814159292,0.4698655764900294,0.6593123718320077,113,64,34,46,10,7,32,18,28,42
"sgc_coral-anthropic3710,sgc_coral-gemini10,sgc_coral-openailong","3,4,3",0.6346153846153846,0.5344772795898101,0.7268731284326717,104,66,0.49557522123893805,0.40017620771878704,0.5912118116445175,113,56,32,37,8,6,34,19,30,51
"sgc_coral-anthropic10,sgc_coral-anthropic3710,sgc_coral-gemini","4,3,1",0.6346153846153846,0.5344772795898101,0.7268731284326717,104,66,0.4690265486725664,0.3745099988696216,0.5652063110236246,113,53,36,37,12,9,30,16,26,51
"sgc_coral-anthropic,sgc_coral-anthropic37,sgc_coral-gemini2510","1,7,2",0.6346153846153846,0.5344772795898101,0.7268731284326717,104,66,0.5398230088495575,0.44351884275715087,0.6339886086814048,113,61,37,43,13,7,29,18,25,45
"sgc_coral-anthropic37,sgc_coral-openai10,sgc_coral-openai45","7,1,1",0.6346153846153846,0.5344772795898101,0.7268731284326717,104,66,0.5575221238938053,0.4610546518661339,0.6508999553070312,113,63,36,44,12,6,30,19,26,44
"sgc_coral-anthropic37,sgc_coral-gemini,sgc_coral-openailong","7,1,3",0.6346153846153846,0.5344772795898101,0.7268731284326717,104,66,0.48672566371681414,0.391592485688175,0.5825715848269355,113,55,34,34,10,4,32,21,28,54
"sgc_coral-gemini2510,sgc_coral-gemma,sgc_coral-openai10","2,1,1",0.6346153846153846,0.5344772795898101,0.7268731284326717,104,66,0.6194690265486725,0.5233464844783339,0.7091663790724447,113,70,47,57,23,12,19,13,15,31
"sgc_coral-gemini2510,sgc_coral-geminipro10,sgc_coral-openaio1","2,1,2",0.6346153846153846,0.5344772795898101,0.7268731284326717,104,66,0.5929203539823009,0.4964726470054805,0.6843740416228519,113,67,35,49,11,7,31,18,27,39
"sgc_coral-gemini2510,sgc_coral-openai10,sgc_coral-openai45","2,1,1",0.6346153846153846,0.5344772795898101,0.7268731284326717,104,66,0.6017699115044248,0.5054005604480631,0.6926685144473006,113,68,45,56,21,13,21,12,17,32
"sgc_coral-anthropic,sgc_coral-gemini2510,sgc_coral-geminipro10","1,2,1",0.6346153846153846,0.5344772795898101,0.7268731284326717,104,66,0.5752212389380531,0.4787054077974483,0.6676956871258655,113,65,43,49,19,9,23,16,19,39
"sgc_coral-anthropic37,sgc_coral-anthropic3710,sgc_coral-openai10o1","7,3,1",0.6346153846153846,0.5344772795898101,0.7268731284326717,104,66,0.4778761061946903,0.38303706099768864,0.5739030980014965,113,54,33,35,9,6,33,19,29,53
"sgc_coral-anthropic,sgc_coral-gemini,sgc_coral-openailong","1,1,3",0.6346153846153846,0.5344772795898101,0.7268731284326717,104,66,0.5752212389380531,0.4787054077974483,0.6676956871258655,113,65,41,49,17,9,25,16,21,39
"sgc_coral-gemini25,sgc_coral-geminipro10,sgc_coral-openai10","2,1,1",0.6346153846153846,0.5344772795898101,0.7268731284326717,104,66,0.37168141592920356,0.28263100798002905,0.4676347962649451,113,42,31,23,7,6,35,19,31,65
"sgc_coral-anthropic37,sgc_coral-geminipro10,sgc_coral-openaio1","7,1,2",0.6346153846153846,0.5344772795898101,0.7268731284326717,104,66,0.46017699115044247,0.3660113913185952,0.5564811572428492,113,52,26,30,2,3,40,22,36,58
"sgc_coral-gemini2510,sgc_coral-openai10o1,sgc_coral-openailong","2,1,3",0.6346153846153846,0.5344772795898101,0.7268731284326717,104,66,0.5663716814159292,0.4698655764900294,0.6593123718320077,113,64,41,50,17,11,25,14,21,38
"sgc_coral-gemini10,sgc_coral-openai10,sgc_coral-openailong","4,1,3",0.6346153846153846,0.5344772795898101,0.7268731284326717,104,66,0.4424778761061947,0.3491000446929689,0.5389453481338661,113,50,32,30,8,5,34,20,30,58
"sgc_coral-anthropic3710,sgc_coral-gemini,sgc_coral-gemini2510","3,1,2",0.6346153846153846,0.5344772795898101,0.7268731284326717,104,66,0.5929203539823009,0.4964726470054805,0.6843740416228519,113,67,46,54,22,12,20,13,16,34
"sgc_coral-anthropic37,sgc_coral-openailong,sgc_coral-openaio1","7,3,2",0.625,0.5246596891713531,0.7180251557221345,104,65,0.5132743362831859,0.41742841517306456,0.608407514311825,113,58,29,37,6,4,36,21,33,51
"sgc_coral-anthropic10,sgc_coral-anthropic3710,sgc_coral-openai4510","4,3,1",0.625,0.5246596891713531,0.7180251557221345,104,65,0.5221238938053098,0.4260969019985035,0.6169629390023114,113,59,32,41,9,7,33,18,30,47
"sgc_coral-openai,sgc_coral-openai10,sgc_coral-openailong","1,1,3",0.625,0.5246596891713531,0.7180251557221345,104,65,0.5309734513274337,0.4347936889763754,0.6254900011303783,113,60,40,42,17,7,25,18,22,46
"sgc_coral-anthropic37,sgc_coral-gemini2510,sgc_coral-gemma","7,2,1",0.625,0.5246596891713531,0.7180251557221345,104,65,0.6017699115044248,0.5054005604480631,0.6926685144473006,113,68,33,50,10,7,32,18,29,38
"sgc_coral-anthropic3710,sgc_coral-gemini25,sgc_coral-openai10","3,2,1",0.625,0.5246596891713531,0.7180251557221345,104,65,0.4336283185840708,0.3406876281679922,0.5301344235099705,113,49,34,30,11,6,31,19,28,58
"sgc_coral-anthropic,sgc_coral-anthropic37,sgc_coral-anthropic3710","1,7,3",0.625,0.5246596891713531,0.7180251557221345,104,65,0.46017699115044247,0.3660113913185952,0.5564811572428492,113,52,33,33,10,6,32,19,29,55
"sgc_coral-anthropic37,sgc_coral-gemini2510,sgc_coral-openai10o1","7,2,1",0.625,0.5246596891713531,0.7180251557221345,104,65,0.5132743362831859,0.41742841517306456,0.608407514311825,113,58,36,41,13,8,29,17,26,47
"sgc_coral-geminipro10,sgc_coral-openai10,sgc_coral-openaio1","1,1,2",0.625,0.5246596891713531,0.7180251557221345,104,65,0.504424778761062,0.4087881883554824,0.599823792281213,113,57,32,39,9,7,33,18,30,49
"sgc_coral-anthropic10,sgc_coral-anthropic37,sgc_coral-openailong","4,7,3",0.625,0.5246596891713531,0.7180251557221345,104,65,0.46017699115044247,0.3660113913185952,0.5564811572428492,113,52,30,32,7,5,35,20,32,56
"sgc_coral-anthropic3710,sgc_coral-geminipro10,sgc_coral-openaio1","3,1,2",0.625,0.5246596891713531,0.7180251557221345,104,65,0.5398230088495575,0.44351884275715087,0.6339886086814048,113,61,31,43,8,7,34,18,31,45
"sgc_coral-anthropic37,sgc_coral-geminipro10,sgc_coral-openai","7,1,1",0.625,0.5246596891713531,0.7180251557221345,104,65,0.4247787610619469,0.33230431287413453,0.5212945922025517,113,48,33,28,10,5,32,20,29,60
"sgc_coral-anthropic10,sgc_coral-openai10o1,sgc_coral-openailong","4,1,3",0.625,0.5246596891713531,0.7180251557221345,104,65,0.504424778761062,0.4087881883554824,0.599823792281213,113,57,32,39,9,7,33,18,30,49
"sgc_coral-anthropic3710,sgc_coral-geminipro10,sgc_coral-openai4510","3,1,1",0.625,0.5246596891713531,0.7180251557221345,104,65,0.4690265486725664,0.3745099988696216,0.5652063110236246,113,53,37,39,14,11,28,14,25,49
"sgc_coral-anthropic3710,sgc_coral-gemini10,sgc_coral-openai10","3,4,1",0.625,0.5246596891713531,0.7180251557221345,104,65,0.45132743362831856,0.35754135758362804,0.5477275431896468,113,51,33,34,10,8,32,17,29,54
"sgc_coral-anthropic3710,sgc_coral-gemini,sgc_coral-geminipro10","3,1,1",0.625,0.5246596891713531,0.7180251557221345,104,65,0.504424778761062,0.4087881883554824,0.599823792281213,113,57,38,41,15,9,27,16,24,47
"sgc_coral-anthropic37,sgc_coral-gemma,sgc_coral-openailong","7,1,3",0.625,0.5246596891713531,0.7180251557221345,104,65,0.504424778761062,0.4087881883554824,0.599823792281213,113,57,30,37,7,5,35,20,32,51
"sgc_coral-anthropic37,sgc_coral-openai,sgc_coral-openailong","7,1,3",0.625,0.5246596891713531,0.7180251557221345,104,65,0.5132743362831859,0.41742841517306456,0.608407514311825,113,58,30,36,7,3,35,22,32,52
"sgc_coral-anthropic3710,sgc_coral-gemini,sgc_coral-gemma","3,1,1",0.625,0.5246596891713531,0.7180251557221345,104,65,0.5575221238938053,0.4610546518661339,0.6508999553070312,113,63,40,47,17,9,25,16,22,41
"sgc_coral-anthropic,sgc_coral-anthropic10,sgc_coral-anthropic37","1,4,7",0.625,0.5246596891713531,0.7180251557221345,104,65,0.4690265486725664,0.3745099988696216,0.5652063110236246,113,53,29,30,6,2,36,23,33,58
"sgc_coral-anthropic,sgc_coral-geminipro10,sgc_coral-openailong","1,1,3",0.625,0.5246596891713531,0.7180251557221345,104,65,0.5309734513274337,0.4347936889763754,0.6254900011303783,113,60,38,43,15,8,27,17,24,45
"sgc_coral-gemini,sgc_coral-openai10,sgc_coral-openailong","1,1,3",0.625,0.5246596891713531,0.7180251557221345,104,65,0.5663716814159292,0.4698655764900294,0.6593123718320077,113,64,42,45,19,6,23,19,20,43
"sgc_coral-gemini25,sgc_coral-gemini2510,sgc_coral-openailong","2,2,3",0.625,0.5246596891713531,0.7180251557221345,104,65,0.504424778761062,0.4087881883554824,0.599823792281213,113,57,36,39,13,7,29,18,26,49
"sgc_coral-anthropic,sgc_coral-geminipro10,sgc_coral-openai10","1,1,1",0.625,0.5246596891713531,0.7180251557221345,104,65,0.4778761061946903,0.38303706099768864,0.5739030980014965,113,54,41,41,18,12,24,13,21,47
"sgc_coral-gemini2510,sgc_coral-gemma,sgc_coral-openaio1","2,1,2",0.625,0.5246596891713531,0.7180251557221345,104,65,0.6548672566371682,0.559609451034119,0.7417860268897711,113,74,33,56,10,7,32,18,29,32
"sgc_coral-gemini2510,sgc_coral-openai4510,sgc_coral-openailong","2,1,3",0.625,0.5246596891713531,0.7180251557221345,104,65,0.5929203539823009,0.4964726470054805,0.6843740416228519,113,67,40,51,17,9,25,16,22,37
"sgc_coral-geminipro,sgc_coral-geminipro10,sgc_coral-openai10","1,1,1",0.625,0.5246596891713531,0.7180251557221345,104,65,0.4690265486725664,0.3745099988696216,0.5652063110236246,113,53,40,40,17,12,25,13,22,48
"sgc_coral-gemini,sgc_coral-gemma,sgc_coral-openailong","1,1,3",0.625,0.5246596891713531,0.7180251557221345,104,65,0.5132743362831859,0.41742841517306456,0.608407514311825,113,58,38,43,15,10,27,15,24,45
"sgc_coral-gemini,sgc_coral-gemini2510,sgc_coral-openai10","1,2,1",0.625,0.5246596891713531,0.7180251557221345,104,65,0.6283185840707964,0.5323652037350549,0.717368992019971,113,71,47,56,24,10,18,15,15,32
"sgc_coral-gemini25,sgc_coral-openai45,sgc_coral-openailong","2,1,3",0.625,0.5246596891713531,0.7180251557221345,104,65,0.4778761061946903,0.38303706099768864,0.5739030980014965,113,54,29,33,6,4,36,21,33,55
"sgc_coral-gemini10,sgc_coral-gemini2510,sgc_coral-openai10","4,2,1",0.625,0.5246596891713531,0.7180251557221345,104,65,0.5309734513274337,0.4347936889763754,0.6254900011303783,113,60,37,43,14,8,28,17,25,45
"sgc_coral-geminipro,sgc_coral-openai10,sgc_coral-openailong","1,1,3",0.625,0.5246596891713531,0.7180251557221345,104,65,0.5309734513274337,0.4347936889763754,0.6254900011303783,113,60,41,43,18,8,24,17,21,45
"sgc_coral-openai,sgc_coral-openai4510,sgc_coral-openailong","1,1,3",0.6153846153846154,0.5148800045618457,0.7091387316544471,104,64,0.5486725663716814,0.4522724568103532,0.642458642416372,113,62,36,47,14,10,28,15,26,41
"sgc_coral-anthropic3710,sgc_coral-gemini25,sgc_coral-geminipro10","3,2,1",0.6153846153846154,0.5148800045618457,0.7091387316544471,104,64,0.40707964601769914,0.3156259583771482,0.5035273529945195,113,46,29,27,7,6,35,19,33,61
"sgc_coral-anthropic,sgc_coral-gemini2510,sgc_coral-openai10","1,2,1",0.6153846153846154,0.5148800045618457,0.7091387316544471,104,64,0.5663716814159292,0.4698655764900294,0.6593123718320077,113,64,43,52,21,13,21,12,19,36
"sgc_coral-geminipro10,sgc_coral-openai10o1,sgc_coral-openailong","1,1,3",0.6153846153846154,0.5148800045618457,0.7091387316544471,104,64,0.4336283185840708,0.3406876281679922,0.5301344235099705,113,49,35,34,13,10,29,15,27,54
"sgc_coral-geminipro10,sgc_coral-openai45,sgc_coral-openailong","1,1,3",0.6153846153846154,0.5148800045618457,0.7091387316544471,104,64,0.5221238938053098,0.4260969019985035,0.6169629390023114,113,59,37,45,15,11,27,14,25,43
"sgc_coral-anthropic37,sgc_coral-openai10o1,sgc_coral-openailong","7,1,3",0.6153846153846154,0.5148800045618457,0.7091387316544471,104,64,0.46017699115044247,0.3660113913185952,0.5564811572428492,113,52,29,32,7,5,35,20,33,56
"sgc_coral-gemini,sgc_coral-gemini2510,sgc_coral-openai10o1","1,2,1",0.6153846153846154,0.5148800045618457,0.7091387316544471,104,64,0.5663716814159292,0.4698655764900294,0.6593123718320077,113,64,42,51,20,12,22,13,20,37
"sgc_coral-gemini2510,sgc_coral-geminipro10,sgc_coral-gemma","2,1,1",0.6153846153846154,0.5148800045618457,0.7091387316544471,104,64,0.584070796460177,0.4875743523159756,0.6760496659713334,113,66,41,55,19,14,23,11,21,33
"sgc_coral-anthropic3710,sgc_coral-gemini,sgc_coral-openai4510","3,1,1",0.6153846153846154,0.5148800045618457,0.7091387316544471,104,64,0.5486725663716814,0.4522724568103532,0.642458642416372,113,62,39,48,17,11,25,14,23,40
"sgc_coral-gemini2510,sgc_coral-openai45,sgc_coral-openai4510","2,1,1",0.6153846153846154,0.5148800045618457,0.7091387316544471,104,64,0.6548672566371682,0.559609451034119,0.7417860268897711,113,74,42,62,20,13,22,12,20,26
"sgc_coral-anthropic10,sgc_coral-geminipro,sgc_coral-openai10","4,1,1",0.6153846153846154,0.5148800045618457,0.7091387316544471,104,64,0.5132743362831859,0.41742841517306456,0.608407514311825,113,58,34,40,12,7,30,18,28,48
"sgc_coral-openai10o1,sgc_coral-openai4510,sgc_coral-openailong","1,1,3",0.6153846153846154,0.5148800045618457,0.7091387316544471,104,64,0.5132743362831859,0.41742841517306456,0.608407514311825,113,58,36,42,14,9,28,16,26,46
"sgc_coral-anthropic,sgc_coral-gemini2510,sgc_coral-gemma","1,2,1",0.6153846153846154,0.5148800045618457,0.7091387316544471,104,64,0.5929203539823009,0.4964726470054805,0.6843740416228519,113,67,44,56,22,14,20,11,18,32
"sgc_coral-anthropic10,sgc_coral-geminipro10,sgc_coral-openailong","4,1,3",0.6153846153846154,0.5148800045618457,0.7091387316544471,104,64,0.4690265486725664,0.3745099988696216,0.5652063110236246,113,53,30,34,8,6,34,19,32,54
"sgc_coral-gemini,sgc_coral-geminipro,sgc_coral-openailong","1,1,3",0.6153846153846154,0.5148800045618457,0.7091387316544471,104,64,0.5575221238938053,0.4610546518661339,0.6508999553070312,113,63,40,45,18,7,24,18,22,43
"sgc_coral-gemini25,sgc_coral-gemini2510,sgc_coral-openai45","2,2,1",0.6153846153846154,0.5148800045618457,0.7091387316544471,104,64,0.5398230088495575,0.44351884275715087,0.6339886086814048,113,61,34,42,12,6,30,19,28,46
"sgc_coral-anthropic3710,sgc_coral-gemini,sgc_coral-openai45","3,1,1",0.6153846153846154,0.5148800045618457,0.7091387316544471,104,64,0.6017699115044248,0.5054005604480631,0.6926685144473006,113,68,39,53,17,10,25,15,23,35
"sgc_coral-anthropic37,sgc_coral-geminipro,sgc_coral-openailong","7,1,3",0.6153846153846154,0.5148800045618457,0.7091387316544471,104,64,0.4778761061946903,0.38303706099768864,0.5739030980014965,113,54,31,34,9,5,33,20,31,54
"sgc_coral-gemma,sgc_coral-openai45,sgc_coral-openailong","1,1,3",0.6153846153846154,0.5148800045618457,0.7091387316544471,104,64,0.5752212389380531,0.4787054077974483,0.6676956871258655,113,65,40,52,18,12,24,13,22,36
"sgc_coral-anthropic3710,sgc_coral-gemini10,sgc_coral-openai4510","3,4,1",0.6153846153846154,0.5148800045618457,0.7091387316544471,104,64,0.4778761061946903,0.38303706099768864,0.5739030980014965,113,54,31,36,9,7,33,18,31,52
"sgc_coral-anthropic3710,sgc_coral-geminipro,sgc_coral-geminipro10","3,1,1",0.6153846153846154,0.5148800045618457,0.7091387316544471,104,64,0.5663716814159292,0.4698655764900294,0.6593123718320077,113,64,40,50,18,11,24,14,22,38
"sgc_coral-anthropic10,sgc_coral-geminipro,sgc_coral-openailong","4,1,3",0.6153846153846154,0.5148800045618457,0.7091387316544471,104,64,0.4778761061946903,0.38303706099768864,0.5739030980014965,113,54,32,35,10,6,32,19,30,53
"sgc_coral-anthropic10,sgc_coral-gemini,sgc_coral-openailong","4,1,3",0.6153846153846154,0.5148800045618457,0.7091387316544471,104,64,0.48672566371681414,0.391592485688175,0.5825715848269355,113,55,32,37,10,7,32,18,30,51
"sgc_coral-anthropic10,sgc_coral-openailong,sgc_coral-openaio1","4,3,2",0.6153846153846154,0.5148800045618457,0.7091387316544471,104,64,0.4778761061946903,0.38303706099768864,0.5739030980014965,113,54,29,35,7,6,35,19,33,53
"sgc_coral-anthropic3710,sgc_coral-openai45,sgc_coral-openai4510","3,1,1",0.6153846153846154,0.5148800045618457,0.7091387316544471,104,64,0.5929203539823009,0.4964726470054805,0.6843740416228519,113,67,38,55,16,13,26,12,24,33
"sgc_coral-anthropic37,sgc_coral-anthropic3710,sgc_coral-gemma","7,3,1",0.6153846153846154,0.5148800045618457,0.7091387316544471,104,64,0.5221238938053098,0.4260969019985035,0.6169629390023114,113,59,31,42,9,8,33,17,31,46
"sgc_coral-anthropic37,sgc_coral-geminipro10,sgc_coral-openailong","7,1,3",0.6153846153846154,0.5148800045618457,0.7091387316544471,104,64,0.4778761061946903,0.38303706099768864,0.5739030980014965,113,54,30,32,8,3,34,22,32,56
"sgc_coral-anthropic37,sgc_coral-geminipro10,sgc_coral-openai4510","7,1,1",0.6153846153846154,0.5148800045618457,0.7091387316544471,104,64,0.45132743362831856,0.35754135758362804,0.5477275431896468,113,51,31,32,9,6,33,19,31,56
"sgc_coral-anthropic3710,sgc_coral-geminipro10,sgc_coral-gemma","3,1,1",0.6153846153846154,0.5148800045618457,0.7091387316544471,104,64,0.5309734513274337,0.4347936889763754,0.6254900011303783,113,60,36,49,14,14,28,11,26,39
"sgc_coral-anthropic37,sgc_coral-anthropic3710,sgc_coral-openai","7,3,1",0.6153846153846154,0.5148800045618457,0.7091387316544471,104,64,0.5132743362831859,0.41742841517306456,0.608407514311825,113,58,32,37,10,4,32,21,30,51
"sgc_coral-anthropic10,sgc_coral-anthropic3710,sgc_coral-openaio1","4,3,2",0.6153846153846154,0.5148800045618457,0.7091387316544471,104,64,0.5309734513274337,0.4347936889763754,0.6254900011303783,113,60,29,41,7,6,35,19,33,47
"sgc_coral-anthropic10,sgc_coral-gemini10,sgc_coral-gemini2510","4,4,2",0.6153846153846154,0.5148800045618457,0.7091387316544471,104,64,0.4336283185840708,0.3406876281679922,0.5301344235099705,113,49,29,31,7,7,35,18,33,57
"sgc_coral-anthropic37,sgc_coral-gemini2510,sgc_coral-geminipro10","7,2,1",0.6153846153846154,0.5148800045618457,0.7091387316544471,104,64,0.5221238938053098,0.4260969019985035,0.6169629390023114,113,59,34,41,12,7,30,18,28,47
"sgc_coral-anthropic,sgc_coral-anthropic10,sgc_coral-anthropic3710","1,4,3",0.6153846153846154,0.5148800045618457,0.7091387316544471,104,64,0.5309734513274337,0.4347936889763754,0.6254900011303783,113,60,33,44,11,9,31,16,29,44
"sgc_coral-geminipro10,sgc_coral-gemma,sgc_coral-openailong","1,1,3",0.6153846153846154,0.5148800045618457,0.7091387316544471,104,64,0.5132743362831859,0.41742841517306456,0.608407514311825,113,58,38,43,16,10,26,15,24,45
"sgc_coral-geminipro,sgc_coral-openai4510,sgc_coral-openailong","1,1,3",0.6153846153846154,0.5148800045618457,0.7091387316544471,104,64,0.5398230088495575,0.44351884275715087,0.6339886086814048,113,61,35,45,13,9,29,16,27,43
"sgc_coral-anthropic3710,sgc_coral-gemma,sgc_coral-openai10o1","3,1,1",0.6153846153846154,0.5148800045618457,0.7091387316544471,104,64,0.5398230088495575,0.44351884275715087,0.6339886086814048,113,61,38,47,16,11,26,14,24,41
"sgc_coral-gemini10,sgc_coral-openai10,sgc_coral-openai45","4,1,1",0.6057692307692307,0.5051377017505615,0.7002144340073123,104,63,0.4778761061946903,0.38303706099768864,0.5739030980014965,113,54,33,38,12,9,30,16,29,50
"sgc_coral-anthropic10,sgc_coral-openai4510,sgc_coral-openailong","4,1,3",0.6057692307692307,0.5051377017505615,0.7002144340073123,104,63,0.504424778761062,0.4087881883554824,0.599823792281213,113,57,30,39,9,7,33,18,32,49
"sgc_coral-gemini25,sgc_coral-openai10,sgc_coral-openailong","2,1,3",0.6057692307692307,0.5051377017505615,0.7002144340073123,104,63,0.4424778761061947,0.3491000446929689,0.5389453481338661,113,50,30,29,9,4,33,21,32,59
"sgc_coral-gemini25,sgc_coral-openai10,sgc_coral-openai45","2,1,1",0.6057692307692307,0.5051377017505615,0.7002144340073123,104,63,0.4690265486725664,0.3745099988696216,0.5652063110236246,113,53,35,35,14,7,28,18,27,53
"sgc_coral-openai10,sgc_coral-openai45,sgc_coral-openaio1","1,1,2",0.6057692307692307,0.5051377017505615,0.7002144340073123,104,63,0.6017699115044248,0.5054005604480631,0.6926685144473006,113,68,36,49,15,6,27,19,26,39
"sgc_coral-anthropic37,sgc_coral-openai10,sgc_coral-openai10o1","7,1,1",0.6057692307692307,0.5051377017505615,0.7002144340073123,104,63,0.4690265486725664,0.3745099988696216,0.5652063110236246,113,53,33,34,12,6,30,19,29,54
"sgc_coral-anthropic37,sgc_coral-geminipro,sgc_coral-openai10","7,1,1",0.6057692307692307,0.5051377017505615,0.7002144340073123,104,63,0.4690265486725664,0.3745099988696216,0.5652063110236246,113,53,34,35,13,7,29,18,28,53
"sgc_coral-anthropic37,sgc_coral-gemma,sgc_coral-openai10","7,1,1",0.6057692307692307,0.5051377017505615,0.7002144340073123,104,63,0.49557522123893805,0.40017620771878704,0.5912118116445175,113,56,34,37,13,6,29,19,28,51
"sgc_coral-geminipro10,sgc_coral-gemma,sgc_coral-openai10","1,1,1",0.6057692307692307,0.5051377017505615,0.7002144340073123,104,63,0.4690265486725664,0.3745099988696216,0.5652063110236246,113,53,37,42,16,14,26,11,25,46
"sgc_coral-anthropic,sgc_coral-anthropic10,sgc_coral-openailong","1,4,3",0.6057692307692307,0.5051377017505615,0.7002144340073123,104,63,0.49557522123893805,0.40017620771878704,0.5912118116445175,113,56,31,38,10,7,32,18,31,50
"sgc_coral-gemini25,sgc_coral-gemini2510,sgc_coral-openaio1","2,2,2",0.6057692307692307,0.5051377017505615,0.7002144340073123,104,63,0.5132743362831859,0.41742841517306456,0.608407514311825,113,58,27,37,6,4,36,21,35,51
"sgc_coral-anthropic10,sgc_coral-openai10,sgc_coral-openai45","4,1,1",0.6057692307692307,0.5051377017505615,0.7002144340073123,104,63,0.5398230088495575,0.44351884275715087,0.6339886086814048,113,61,34,45,13,9,29,16,28,43
"sgc_coral-anthropic10,sgc_coral-openai10,sgc_coral-openai10o1","4,1,1",0.6057692307692307,0.5051377017505615,0.7002144340073123,104,63,0.4690265486725664,0.3745099988696216,0.5652063110236246,113,53,33,37,12,9,30,16,29,51
"sgc_coral-anthropic10,sgc_coral-openai,sgc_coral-openailong","4,1,3",0.6057692307692307,0.5051377017505615,0.7002144340073123,104,63,0.4778761061946903,0.38303706099768864,0.5739030980014965,113,54,28,36,7,7,35,18,34,52
"sgc_coral-anthropic10,sgc_coral-gemma,sgc_coral-openailong","4,1,3",0.6057692307692307,0.5051377017505615,0.7002144340073123,104,63,0.5486725663716814,0.4522724568103532,0.642458642416372,113,62,29,43,8,6,34,19,33,45
"sgc_coral-anthropic,sgc_coral-gemini2510,sgc_coral-openai45","1,2,1",0.6057692307692307,0.5051377017505615,0.7002144340073123,104,63,0.6106194690265486,0.5143583942222505,0.7009327503651719,113,69,43,57,22,13,20,12,19,31
"sgc_coral-anthropic37,sgc_coral-openai10,sgc_coral-openai4510","7,1,1",0.6057692307692307,0.5051377017505615,0.7002144340073123,104,63,0.4690265486725664,0.3745099988696216,0.5652063110236246,113,53,32,34,11,6,31,19,30,54
"sgc_coral-anthropic3710,sgc_coral-openai,sgc_coral-openai10","3,1,1",0.6057692307692307,0.5051377017505615,0.7002144340073123,104,63,0.5486725663716814,0.4522724568103532,0.642458642416372,113,62,38,45,17,8,25,17,24,43
"sgc_coral-anthropic10,sgc_coral-gemini2510,sgc_coral-openai","4,2,1",0.6057692307692307,0.5051377017505615,0.7002144340073123,104,63,0.5752212389380531,0.4787054077974483,0.6676956871258655,113,65,33,48,12,8,30,17,29,40
"sgc_coral-anthropic3710,sgc_coral-gemini,sgc_coral-openaio1","3,1,2",0.6057692307692307,0.5051377017505615,0.7002144340073123,104,63,0.5221238938053098,0.4260969019985035,0.6169629390023114,113,59,31,40,10,6,32,19,31,48
"sgc_coral-anthropic37,sgc_coral-gemini25,sgc_coral-openailong","7,2,3",0.6057692307692307,0.5051377017505615,0.7002144340073123,104,63,0.4247787610619469,0.33230431287413453,0.5212945922025517,113,48,28,25,7,2,35,23,34,63
"sgc_coral-anthropic3710,sgc_coral-geminipro,sgc_coral-openai4510","3,1,1",0.6057692307692307,0.5051377017505615,0.7002144340073123,104,63,0.5486725663716814,0.4522724568103532,0.642458642416372,113,62,35,47,14,10,28,15,27,41
"sgc_coral-anthropic10,sgc_coral-gemini,sgc_coral-openaio1","4,1,2",0.6057692307692307,0.5051377017505615,0.7002144340073123,104,63,0.4778761061946903,0.38303706099768864,0.5739030980014965,113,54,26,34,5,5,37,20,36,54
"sgc_coral-gemini2510,sgc_coral-openai45,sgc_coral-openaio1","2,1,2",0.6057692307692307,0.5051377017505615,0.7002144340073123,104,63,0.6637168141592921,0.5687552162567255,0.7498596396389975,113,75,35,57,14,7,28,18,27,31
"sgc_coral-openai45,sgc_coral-openailong,sgc_coral-openaio1","1,3,2",0.6057692307692307,0.5051377017505615,0.7002144340073123,104,63,0.5929203539823009,0.4964726470054805,0.6843740416228519,113,67,30,47,9,5,33,20,32,41
"sgc_coral-anthropic3710,sgc_coral-openai4510,sgc_coral-openaio1","3,1,2",0.6057692307692307,0.5051377017505615,0.7002144340073123,104,63,0.5929203539823009,0.4964726470054805,0.6843740416228519,113,67,30,47,9,5,33,20,32,41
"sgc_coral-anthropic,sgc_coral-openai45,sgc_coral-openailong","1,1,3",0.6057692307692307,0.5051377017505615,0.7002144340073123,104,63,0.5221238938053098,0.4260969019985035,0.6169629390023114,113,59,39,45,18,11,24,14,23,43
"sgc_coral-anthropic3710,sgc_coral-geminipro10,sgc_coral-openai45","3,1,1",0.6057692307692307,0.5051377017505615,0.7002144340073123,104,63,0.5486725663716814,0.4522724568103532,0.642458642416372,113,62,36,49,15,12,27,13,26,39
"sgc_coral-anthropic3710,sgc_coral-openai10o1,sgc_coral-openai4510","3,1,1",0.6057692307692307,0.5051377017505615,0.7002144340073123,104,63,0.5221238938053098,0.4260969019985035,0.6169629390023114,113,59,37,46,16,12,26,13,25,42
"sgc_coral-anthropic,sgc_coral-anthropic3710,sgc_coral-geminipro","1,3,1",0.6057692307692307,0.5051377017505615,0.7002144340073123,104,63,0.5929203539823009,0.4964726470054805,0.6843740416228519,113,67,41,51,20,9,22,16,21,37
"sgc_coral-gemini2510,sgc_coral-openai,sgc_coral-openai45","2,1,1",0.6057692307692307,0.5051377017505615,0.7002144340073123,104,63,0.6106194690265486,0.5143583942222505,0.7009327503651719,113,69,43,56,22,12,20,13,19,32
"sgc_coral-anthropic,sgc_coral-gemini,sgc_coral-gemini2510","1,1,2",0.6057692307692307,0.5051377017505615,0.7002144340073123,104,63,0.6460176991150443,0.5504962136889733,0.7336793311699545,113,73,43,59,22,11,20,14,19,29
"sgc_coral-anthropic,sgc_coral-anthropic3710,sgc_coral-openai45","1,3,1",0.6057692307692307,0.5051377017505615,0.7002144340073123,104,63,0.5575221238938053,0.4610546518661339,0.6508999553070312,113,63,42,51,21,13,21,12,20,37
"sgc_coral-anthropic37,sgc_coral-gemini10,sgc_coral-openailong","7,4,3",0.6057692307692307,0.5051377017505615,0.7002144340073123,104,63,0.4424778761061947,0.3491000446929689,0.5389453481338661,113,50,28,29,7,4,35,21,34,59
"sgc_coral-anthropic10,sgc_coral-anthropic3710,sgc_coral-openai","4,3,1",0.6057692307692307,0.5051377017505615,0.7002144340073123,104,63,0.5575221238938053,0.4610546518661339,0.6508999553070312,113,63,31,42,10,4,32,21,31,46
"sgc_coral-anthropic10,sgc_coral-anthropic3710,sgc_coral-gemma","4,3,1",0.6057692307692307,0.5051377017505615,0.7002144340073123,104,63,0.5221238938053098,0.4260969019985035,0.6169629390023114,113,59,31,43,10,9,32,16,31,45
"sgc_coral-anthropic10,sgc_coral-anthropic37,sgc_coral-openai45","4,7,1",0.6057692307692307,0.5051377017505615,0.7002144340073123,104,63,0.48672566371681414,0.391592485688175,0.5825715848269355,113,55,27,33,6,3,36,22,35,55
"sgc_coral-anthropic,sgc_coral-gemini10,sgc_coral-gemini2510","1,4,2",0.6057692307692307,0.5051377017505615,0.7002144340073123,104,63,0.5132743362831859,0.41742841517306456,0.608407514311825,113,58,34,42,13,9,29,16,28,46
"sgc_coral-anthropic,sgc_coral-gemini25,sgc_coral-gemini2510","1,2,2",0.6057692307692307,0.5051377017505615,0.7002144340073123,104,63,0.48672566371681414,0.391592485688175,0.5825715848269355,113,55,36,38,15,8,27,17,26,50
"sgc_coral-gemini,sgc_coral-gemini25,sgc_coral-gemini2510","1,2,2",0.6057692307692307,0.5051377017505615,0.7002144340073123,104,63,0.4778761061946903,0.38303706099768864,0.5739030980014965,113,54,36,36,15,7,27,18,26,52
"sgc_coral-anthropic37,sgc_coral-gemini,sgc_coral-openai10","7,1,1",0.6057692307692307,0.5051377017505615,0.7002144340073123,104,63,0.49557522123893805,0.40017620771878704,0.5912118116445175,113,56,36,35,15,4,27,21,26,53
"sgc_coral-anthropic3710,sgc_coral-gemini10,sgc_coral-geminipro10","3,4,1",0.6057692307692307,0.5051377017505615,0.7002144340073123,104,63,0.415929203539823,0.3239503340286666,0.5124256476840243,113,47,28,29,7,7,35,18,34,59
"sgc_coral-gemini,sgc_coral-openai10,sgc_coral-openaio1","1,1,2",0.6057692307692307,0.5051377017505615,0.7002144340073123,104,63,0.5752212389380531,0.4787054077974483,0.6676956871258655,113,65,35,46,14,6,28,19,27,42
"sgc_coral-gemma,sgc_coral-openai10o1,sgc_coral-openailong","1,1,3",0.6057692307692307,0.5051377017505615,0.7002144340073123,104,63,0.48672566371681414,0.391592485688175,0.5825715848269355,113,55,33,43,12,13,30,12,29,45
"sgc_coral-gemini,sgc_coral-geminipro10,sgc_coral-openailong","1,1,3",0.6057692307692307,0.5051377017505615,0.7002144340073123,104,63,0.49557522123893805,0.40017620771878704,0.5912118116445175,113,56,36,39,15,8,27,17,26,49
"sgc_coral-geminipro10,sgc_coral-openailong,sgc_coral-openaio1","1,3,2",0.6057692307692307,0.5051377017505615,0.7002144340073123,104,63,0.5132743362831859,0.41742841517306456,0.608407514311825,113,58,27,37,6,4,36,21,35,51
"sgc_coral-anthropic37,sgc_coral-anthropic3710,sgc_coral-gemini10","7,3,4",0.6057692307692307,0.5051377017505615,0.7002144340073123,104,63,0.415929203539823,0.3239503340286666,0.5124256476840243,113,47,27,27,6,5,36,20,35,61
"sgc_coral-anthropic3710,sgc_coral-gemini25,sgc_coral-geminipro","3,2,1",0.6057692307692307,0.5051377017505615,0.7002144340073123,104,63,0.4424778761061947,0.3491000446929689,0.5389453481338661,113,50,31,31,10,6,32,19,31,57
"sgc_coral-anthropic37,sgc_coral-gemini,sgc_coral-geminipro10","7,1,1",0.6057692307692307,0.5051377017505615,0.7002144340073123,104,63,0.4690265486725664,0.3745099988696216,0.5652063110236246,113,53,32,33,11,5,31,20,30,55
"sgc_coral-gemini2510,sgc_coral-geminipro10,sgc_coral-openai45","2,1,1",0.6057692307692307,0.5051377017505615,0.7002144340073123,104,63,0.5663716814159292,0.4698655764900294,0.6593123718320077,113,64,40,53,19,14,23,11,22,35
"sgc_coral-anthropic,sgc_coral-anthropic37,sgc_coral-openailong","1,7,3",0.6057692307692307,0.5051377017505615,0.7002144340073123,104,63,0.48672566371681414,0.391592485688175,0.5825715848269355,113,55,30,34,9,4,33,21,32,54
"sgc_coral-gemini,sgc_coral-gemini2510,sgc_coral-gemma","1,2,1",0.6057692307692307,0.5051377017505615,0.7002144340073123,104,63,0.6283185840707964,0.5323652037350549,0.717368992019971,113,71,42,57,21,11,21,14,20,31
"sgc_coral-gemini,sgc_coral-gemini2510,sgc_coral-geminipro10","1,2,1",0.6057692307692307,0.5051377017505615,0.7002144340073123,104,63,0.5398230088495575,0.44351884275715087,0.6339886086814048,113,61,39,47,18,11,24,14,23,41
"sgc_coral-gemini2510,sgc_coral-geminipro,sgc_coral-openaio1","2,1,2",0.5961538461538461,0.49543231082908396,0.691252783311745,104,62,0.5752212389380531,0.4787054077974483,0.6676956871258655,113,65,36,49,16,9,26,16,26,39
"sgc_coral-gemini25,sgc_coral-openailong,sgc_coral-openaio1","2,3,2",0.5961538461538461,0.49543231082908396,0.691252783311745,104,62,0.4690265486725664,0.3745099988696216,0.5652063110236246,113,53,25,32,5,4,37,21,37,56
"sgc_coral-openai10,sgc_coral-openai4510,sgc_coral-openaio1","1,1,2",0.5961538461538461,0.49543231082908396,0.691252783311745,104,62,0.5132743362831859,0.41742841517306456,0.608407514311825,113,58,30,41,10,8,32,17,32,47
"sgc_coral-gemini25,sgc_coral-openai4510,sgc_coral-openailong","2,1,3",0.5961538461538461,0.49543231082908396,0.691252783311745,104,62,0.45132743362831856,0.35754135758362804,0.5477275431896468,113,51,27,31,7,5,35,20,35,57
"sgc_coral-openai10o1,sgc_coral-openai45,sgc_coral-openailong","1,1,3",0.5961538461538461,0.49543231082908396,0.691252783311745,104,62,0.5309734513274337,0.4347936889763754,0.6254900011303783,113,60,36,45,16,10,26,15,26,43
"sgc_coral-gemini2510,sgc_coral-geminipro,sgc_coral-openai4510","2,1,1",0.5961538461538461,0.49543231082908396,0.691252783311745,104,62,0.6371681415929203,0.5414149629210798,0.7255401401231517,113,72,40,58,20,11,22,14,22,30
"sgc_coral-gemini10,sgc_coral-gemini2510,sgc_coral-openai45","4,2,1",0.5961538461538461,0.49543231082908396,0.691252783311745,104,62,0.5309734513274337,0.4347936889763754,0.6254900011303783,113,60,31,41,11,6,31,19,31,47
"sgc_coral-gemini25,sgc_coral-openai10o1,sgc_coral-openailong","2,1,3",0.5961538461538461,0.49543231082908396,0.691252783311745,104,62,0.415929203539823,0.3239503340286666,0.5124256476840243,113,47,28,27,8,5,34,20,34,61
"sgc_coral-gemini25,sgc_coral-gemma,sgc_coral-openailong","2,1,3",0.5961538461538461,0.49543231082908396,0.691252783311745,104,62,0.4424778761061947,0.3491000446929689,0.5389453481338661,113,50,27,30,7,5,35,20,35,58
"sgc_coral-anthropic3710,sgc_coral-openai10o1,sgc_coral-openai45","3,1,1",0.5961538461538461,0.49543231082908396,0.691252783311745,104,62,0.5752212389380531,0.4787054077974483,0.6676956871258655,113,65,38,51,18,11,24,14,24,37
"sgc_coral-geminipro10,sgc_coral-openai,sgc_coral-openailong","1,1,3",0.5961538461538461,0.49543231082908396,0.691252783311745,104,62,0.4778761061946903,0.38303706099768864,0.5739030980014965,113,54,35,38,15,9,27,16,27,50
"sgc_coral-geminipro10,sgc_coral-openai10,sgc_coral-openai10o1","1,1,1",0.5961538461538461,0.49543231082908396,0.691252783311745,104,62,0.4778761061946903,0.38303706099768864,0.5739030980014965,113,54,36,41,16,12,26,13,26,47
"sgc_coral-gemini2510,sgc_coral-openai,sgc_coral-openai4510","2,1,1",0.5961538461538461,0.49543231082908396,0.691252783311745,104,62,0.5929203539823009,0.4964726470054805,0.6843740416228519,113,67,39,54,19,12,23,13,23,34
"sgc_coral-anthropic3710,sgc_coral-geminipro,sgc_coral-openai45","3,1,1",0.5961538461538461,0.49543231082908396,0.691252783311745,104,62,0.5929203539823009,0.4964726470054805,0.6843740416228519,113,67,39,52,19,10,23,15,23,36
"sgc_coral-gemini,sgc_coral-gemini10,sgc_coral-gemini2510","1,4,2",0.5961538461538461,0.49543231082908396,0.691252783311745,104,62,0.5221238938053098,0.4260969019985035,0.6169629390023114,113,59,35,40,15,6,27,19,27,48
"sgc_coral-geminipro10,sgc_coral-openai10,sgc_coral-openai45","1,1,1",0.5961538461538461,0.49543231082908396,0.691252783311745,104,62,0.5398230088495575,0.44351884275715087,0.6339886086814048,113,61,36,47,16,11,26,14,26,41
"sgc_coral-geminipro10,sgc_coral-openai45,sgc_coral-openaio1","1,1,2",0.5961538461538461,0.49543231082908396,0.691252783311745,104,62,0.5486725663716814,0.4522724568103532,0.642458642416372,113,62,32,47,12,10,30,15,30,41
"sgc_coral-anthropic3710,sgc_coral-gemini25,sgc_coral-openai4510","3,2,1",0.5961538461538461,0.49543231082908396,0.691252783311745,104,62,0.45132743362831856,0.35754135758362804,0.5477275431896468,113,51,28,33,8,7,34,18,34,55
"sgc_coral-gemini,sgc_coral-gemini2510,sgc_coral-openai45","1,2,1",0.5961538461538461,0.49543231082908396,0.691252783311745,104,62,0.6902654867256637,0.5963938602613119,0.7738752807391943,113,78,40,63,20,10,22,15,22,25
"sgc_coral-gemini,sgc_coral-gemini2510,sgc_coral-openaio1","1,2,2",0.5961538461538461,0.49543231082908396,0.691252783311745,104,62,0.6106194690265486,0.5143583942222505,0.7009327503651719,113,69,34,50,14,6,28,19,28,38
"sgc_coral-anthropic3710,sgc_coral-gemini10,sgc_coral-openai45","3,4,1",0.5961538461538461,0.49543231082908396,0.691252783311745,104,62,0.5398230088495575,0.44351884275715087,0.6339886086814048,113,61,30,42,10,6,32,19,32,46
"sgc_coral-gemma,sgc_coral-openailong,sgc_coral-openaio1","1,3,2",0.5961538461538461,0.49543231082908396,0.691252783311745,104,62,0.5575221238938053,0.4610546518661339,0.6508999553070312,113,63,28,42,8,4,34,21,34,46
"sgc_coral-anthropic3710,sgc_coral-gemini,sgc_coral-openai10o1","3,1,1",0.5961538461538461,0.49543231082908396,0.691252783311745,104,62,0.504424778761062,0.4087881883554824,0.599823792281213,113,57,37,43,17,11,25,14,25,45
"sgc_coral-gemini10,sgc_coral-openai45,sgc_coral-openailong","4,1,3",0.5961538461538461,0.49543231082908396,0.691252783311745,104,62,0.48672566371681414,0.391592485688175,0.5825715848269355,113,55,27,35,7,5,35,20,35,53
"sgc_coral-gemini25,sgc_coral-gemini2510,sgc_coral-geminipro","2,2,1",0.5961538461538461,0.49543231082908396,0.691252783311745,104,62,0.49557522123893805,0.40017620771878704,0.5912118116445175,113,56,35,40,15,9,27,16,27,48
"sgc_coral-anthropic3710,sgc_coral-gemini,sgc_coral-gemini10","3,1,4",0.5961538461538461,0.49543231082908396,0.691252783311745,104,62,0.46017699115044247,0.3660113913185952,0.5564811572428492,113,52,31,35,11,8,31,17,31,53
"sgc_coral-gemini25,sgc_coral-gemini2510,sgc_coral-geminipro10","2,2,1",0.5961538461538461,0.49543231082908396,0.691252783311745,104,62,0.4690265486725664,0.3745099988696216,0.5652063110236246,113,53,32,36,12,8,30,17,30,52
"sgc_coral-anthropic37,sgc_coral-openai10,sgc_coral-openaio1","7,1,2",0.5961538461538461,0.49543231082908396,0.691252783311745,104,62,0.5221238938053098,0.4260969019985035,0.6169629390023114,113,59,27,36,7,2,35,23,35,52
"sgc_coral-openai,sgc_coral-openailong,sgc_coral-openaio1","1,3,2",0.5961538461538461,0.49543231082908396,0.691252783311745,104,62,0.5663716814159292,0.4698655764900294,0.6593123718320077,113,64,28,44,8,5,34,20,34,44
"sgc_coral-anthropic37,sgc_coral-gemma,sgc_coral-openaio1","7,1,2",0.5961538461538461,0.49543231082908396,0.691252783311745,104,62,0.5132743362831859,0.41742841517306456,0.608407514311825,113,58,25,36,5,3,37,22,37,52
"sgc_coral-anthropic37,sgc_coral-gemma,sgc_coral-openai10o1","7,1,1",0.5961538461538461,0.49543231082908396,0.691252783311745,104,62,0.4778761061946903,0.38303706099768864,0.5739030980014965,113,54,28,38,8,9,34,16,34,50
"sgc_coral-gemini25,sgc_coral-geminipro10,sgc_coral-openailong","2,1,3",0.5961538461538461,0.49543231082908396,0.691252783311745,104,62,0.45132743362831856,0.35754135758362804,0.5477275431896468,113,51,28,31,8,5,34,20,34,57
"sgc_coral-anthropic3710,sgc_coral-geminipro,sgc_coral-openaio1","3,1,2",0.5961538461538461,0.49543231082908396,0.691252783311745,104,62,0.5309734513274337,0.4347936889763754,0.6254900011303783,113,60,31,43,11,8,31,17,31,45
"sgc_coral-anthropic3710,sgc_coral-geminipro,sgc_coral-gemma","3,1,1",0.5961538461538461,0.49543231082908396,0.691252783311745,104,62,0.5309734513274337,0.4347936889763754,0.6254900011303783,113,60,39,47,19,12,23,13,23,41
"sgc_coral-anthropic,sgc_coral-gemini,sgc_coral-geminipro10","1,1,1",0.5961538461538461,0.49543231082908396,0.691252783311745,104,62,0.504424778761062,0.4087881883554824,0.599823792281213,113,57,39,43,19,11,23,14,23,45
"sgc_coral-anthropic,sgc_coral-anthropic37,sgc_coral-openai10","1,7,1",0.5961538461538461,0.49543231082908396,0.691252783311745,104,62,0.4690265486725664,0.3745099988696216,0.5652063110236246,113,53,32,33,12,5,30,20,30,55
"sgc_coral-anthropic10,sgc_coral-openai10,sgc_coral-openaio1","4,1,2",0.5961538461538461,0.49543231082908396,0.691252783311745,104,62,0.49557522123893805,0.40017620771878704,0.5912118116445175,113,56,28,36,8,5,34,20,34,52
"sgc_coral-anthropic,sgc_coral-gemini2510,sgc_coral-openai4510","1,2,1",0.5961538461538461,0.49543231082908396,0.691252783311745,104,62,0.5752212389380531,0.4787054077974483,0.6676956871258655,113,65,44,52,24,12,18,13,18,36
"sgc_coral-anthropic37,sgc_coral-anthropic3710,sgc_coral-gemini25","7,3,2",0.5961538461538461,0.49543231082908396,0.691252783311745,104,62,0.39823008849557523,0.30733148555269946,0.4945994395519369,113,45,26,24,6,4,36,21,36,64
"sgc_coral-anthropic,sgc_coral-gemini25,sgc_coral-openai10","1,2,1",0.5961538461538461,0.49543231082908396,0.691252783311745,104,62,0.45132743362831856,0.35754135758362804,0.5477275431896468,113,51,33,31,13,5,29,20,29,57
"sgc_coral-anthropic10,sgc_coral-gemma,sgc_coral-openai10","4,1,1",0.5961538461538461,0.49543231082908396,0.691252783311745,104,62,0.5309734513274337,0.4347936889763754,0.6254900011303783,113,60,34,45,14,10,28,15,28,43
"sgc_coral-anthropic37,sgc_coral-anthropic3710,sgc_coral-openai4510","7,3,1",0.5961538461538461,0.49543231082908396,0.691252783311745,104,62,0.49557522123893805,0.40017620771878704,0.5912118116445175,113,56,29,38,9,7,33,18,33,50
"sgc_coral-anthropic10,sgc_coral-geminipro10,sgc_coral-openai4510","4,1,1",0.5961538461538461,0.49543231082908396,0.691252783311745,104,62,0.4247787610619469,0.33230431287413453,0.5212945922025517,113,48,29,34,9,11,33,14,33,54
"sgc_coral-anthropic,sgc_coral-openai10,sgc_coral-openai4510","1,1,1",0.5961538461538461,0.49543231082908396,0.691252783311745,104,62,0.5309734513274337,0.4347936889763754,0.6254900011303783,113,60,39,47,19,12,23,13,23,41
"sgc_coral-anthropic,sgc_coral-anthropic3710,sgc_coral-openaio1","1,3,2",0.5961538461538461,0.49543231082908396,0.691252783311745,104,62,0.5398230088495575,0.44351884275715087,0.6339886086814048,113,61,32,43,12,7,30,18,30,45
"sgc_coral-anthropic,sgc_coral-anthropic3710,sgc_coral-openai4510","1,3,1",0.5961538461538461,0.49543231082908396,0.691252783311745,104,62,0.5309734513274337,0.4347936889763754,0.6254900011303783,113,60,39,45,19,10,23,15,23,43
"sgc_coral-anthropic37,sgc_coral-gemini,sgc_coral-openai45","7,1,1",0.5961538461538461,0.49543231082908396,0.691252783311745,104,62,0.5132743362831859,0.41742841517306456,0.608407514311825,113,58,32,42,12,9,30,16,30,46
"sgc_coral-anthropic37,sgc_coral-gemini,sgc_coral-openaio1","7,1,2",0.5961538461538461,0.49543231082908396,0.691252783311745,104,62,0.49557522123893805,0.40017620771878704,0.5912118116445175,113,56,24,33,4,2,38,23,38,55
"sgc_coral-anthropic10,sgc_coral-openai10,sgc_coral-openai4510","4,1,1",0.5961538461538461,0.49543231082908396,0.691252783311745,104,62,0.5309734513274337,0.4347936889763754,0.6254900011303783,113,60,31,42,11,7,31,18,31,46
"sgc_coral-anthropic10,sgc_coral-anthropic3710,sgc_coral-gemini10","4,3,4",0.5961538461538461,0.49543231082908396,0.691252783311745,104,62,0.415929203539823,0.3239503340286666,0.5124256476840243,113,47,26,28,6,6,36,19,36,60
"sgc_coral-anthropic10,sgc_coral-anthropic3710,sgc_coral-openai10o1","4,3,1",0.5961538461538461,0.49543231082908396,0.691252783311745,104,62,0.5132743362831859,0.41742841517306456,0.608407514311825,113,58,29,41,9,8,33,17,33,47
"sgc_coral-anthropic,sgc_coral-anthropic37,sgc_coral-gemini25","1,7,2",0.5961538461538461,0.49543231082908396,0.691252783311745,104,62,0.3805309734513274,0.2908336209275553,0.4766535155216661,113,43,25,20,5,2,37,23,37,68
"sgc_coral-anthropic,sgc_coral-anthropic10,sgc_coral-geminipro10","1,4,1",0.5961538461538461,0.49543231082908396,0.691252783311745,104,62,0.45132743362831856,0.35754135758362804,0.5477275431896468,113,51,31,33,11,7,31,18,31,55
"sgc_coral-anthropic10,sgc_coral-gemini2510,sgc_coral-openai10o1","4,2,1",0.5961538461538461,0.49543231082908396,0.691252783311745,104,62,0.5132743362831859,0.41742841517306456,0.608407514311825,113,58,35,43,15,10,27,15,27,45
"sgc_coral-gemini10,sgc_coral-gemini2510,sgc_coral-geminipro10","4,2,1",0.5865384615384616,0.4857634129951128,0.6822542462493977,104,61,0.49557522123893805,0.40017620771878704,0.5912118116445175,113,56,31,40,12,9,30,16,31,48
"sgc_coral-anthropic10,sgc_coral-anthropic3710,sgc_coral-gemini25","4,3,2",0.5865384615384616,0.4857634129951128,0.6822542462493977,104,61,0.4247787610619469,0.33230431287413453,0.5212945922025517,113,48,25,28,6,5,36,20,37,60
"sgc_coral-anthropic37,sgc_coral-openai4510,sgc_coral-openailong","7,1,3",0.5865384615384616,0.4857634129951128,0.6822542462493977,104,61,0.4690265486725664,0.3745099988696216,0.5652063110236246,113,53,26,33,7,5,35,20,36,55
"sgc_coral-anthropic37,sgc_coral-openai45,sgc_coral-openaio1","7,1,2",0.5865384615384616,0.4857634129951128,0.6822542462493977,104,61,0.5309734513274337,0.4347936889763754,0.6254900011303783,113,60,25,39,6,4,36,21,37,49
"sgc_coral-anthropic10,sgc_coral-gemma,sgc_coral-openai10o1","4,1,1",0.5865384615384616,0.4857634129951128,0.6822542462493977,104,61,0.49557522123893805,0.40017620771878704,0.5912118116445175,113,56,28,43,9,12,33,13,34,45
"sgc_coral-anthropic10,sgc_coral-anthropic37,sgc_coral-gemini","4,7,1",0.5865384615384616,0.4857634129951128,0.6822542462493977,104,61,0.4424778761061947,0.3491000446929689,0.5389453481338661,113,50,26,29,7,4,35,21,36,59
"sgc_coral-gemini10,sgc_coral-gemma,sgc_coral-openailong","4,1,3",0.5865384615384616,0.4857634129951128,0.6822542462493977,104,61,0.4690265486725664,0.3745099988696216,0.5652063110236246,113,53,26,35,7,7,35,18,36,53
"sgc_coral-gemini,sgc_coral-openailong,sgc_coral-openaio1","1,3,2",0.5865384615384616,0.4857634129951128,0.6822542462493977,104,61,0.5575221238938053,0.4610546518661339,0.6508999553070312,113,63,29,42,10,4,32,21,33,46
"sgc_coral-gemini10,sgc_coral-openai10o1,sgc_coral-openailong","4,1,3",0.5865384615384616,0.4857634129951128,0.6822542462493977,104,61,0.40707964601769914,0.3156259583771482,0.5035273529945195,113,46,26,27,7,6,35,19,36,61
"sgc_coral-gemini10,sgc_coral-openai4510,sgc_coral-openailong","4,1,3",0.5865384615384616,0.4857634129951128,0.6822542462493977,104,61,0.46017699115044247,0.3660113913185952,0.5564811572428492,113,52,27,33,8,6,34,19,35,55
"sgc_coral-anthropic10,sgc_coral-gemini25,sgc_coral-gemini2510","4,2,2",0.5865384615384616,0.4857634129951128,0.6822542462493977,104,61,0.4778761061946903,0.38303706099768864,0.5739030980014965,113,54,28,35,9,6,33,19,34,53
"sgc_coral-anthropic,sgc_coral-geminipro,sgc_coral-openailong","1,1,3",0.5865384615384616,0.4857634129951128,0.6822542462493977,104,61,0.5309734513274337,0.4347936889763754,0.6254900011303783,113,60,39,45,20,10,22,15,23,43
"sgc_coral-anthropic10,sgc_coral-gemini25,sgc_coral-openai10","4,2,1",0.5865384615384616,0.4857634129951128,0.6822542462493977,104,61,0.37168141592920356,0.28263100798002905,0.4676347962649451,113,42,25,21,6,4,36,21,37,67
"sgc_coral-anthropic10,sgc_coral-gemma,sgc_coral-openaio1","4,1,2",0.5865384615384616,0.4857634129951128,0.6822542462493977,104,61,0.5575221238938053,0.4610546518661339,0.6508999553070312,113,63,24,42,5,4,37,21,38,46
"sgc_coral-anthropic10,sgc_coral-anthropic37,sgc_coral-openai","4,7,1",0.5865384615384616,0.4857634129951128,0.6822542462493977,104,61,0.4778761061946903,0.38303706099768864,0.5739030980014965,113,54,24,32,5,3,37,22,38,56
"sgc_coral-anthropic3710,sgc_coral-openai10o1,sgc_coral-openaio1","3,1,2",0.5865384615384616,0.4857634129951128,0.6822542462493977,104,61,0.5486725663716814,0.4522724568103532,0.642458642416372,113,62,28,44,9,7,33,18,34,44
"sgc_coral-anthropic3710,sgc_coral-gemini,sgc_coral-gemini25","3,1,2",0.5865384615384616,0.4857634129951128,0.6822542462493977,104,61,0.45132743362831856,0.35754135758362804,0.5477275431896468,113,51,30,33,11,7,31,18,32,55
"sgc_coral-gemini,sgc_coral-openai45,sgc_coral-openailong","1,1,3",0.5865384615384616,0.4857634129951128,0.6822542462493977,104,61,0.584070796460177,0.4875743523159756,0.6760496659713334,113,66,34,51,15,10,27,15,28,37
"sgc_coral-anthropic10,sgc_coral-geminipro10,sgc_coral-openai10o1","4,1,1",0.5865384615384616,0.4857634129951128,0.6822542462493977,104,61,0.39823008849557523,0.30733148555269946,0.4945994395519369,113,45,29,29,10,9,32,16,33,59
"sgc_coral-gemini,sgc_coral-geminipro10,sgc_coral-openaio1","1,1,2",0.5865384615384616,0.4857634129951128,0.6822542462493977,104,61,0.5221238938053098,0.4260969019985035,0.6169629390023114,113,59,30,42,11,8,31,17,32,46
"sgc_coral-gemini,sgc_coral-geminipro10,sgc_coral-openai10","1,1,1",0.5865384615384616,0.4857634129951128,0.6822542462493977,104,61,0.504424778761062,0.4087881883554824,0.599823792281213,113,57,39,43,20,11,22,14,23,45
"sgc_coral-anthropic,sgc_coral-openai10,sgc_coral-openai45","1,1,1",0.5865384615384616,0.4857634129951128,0.6822542462493977,104,61,0.5752212389380531,0.4787054077974483,0.6676956871258655,113,65,41,51,22,11,20,14,21,37
"sgc_coral-anthropic37,sgc_coral-gemma,sgc_coral-openai4510","7,1,1",0.5865384615384616,0.4857634129951128,0.6822542462493977,104,61,0.5221238938053098,0.4260969019985035,0.6169629390023114,113,59,28,41,9,7,33,18,34,47
"sgc_coral-anthropic10,sgc_coral-anthropic37,sgc_coral-geminipro10","4,7,1",0.5865384615384616,0.4857634129951128,0.6822542462493977,104,61,0.4336283185840708,0.3406876281679922,0.5301344235099705,113,49,24,26,5,2,37,23,38,62
"sgc_coral-anthropic10,sgc_coral-anthropic37,sgc_coral-geminipro","4,7,1",0.5865384615384616,0.4857634129951128,0.6822542462493977,104,61,0.4424778761061947,0.3491000446929689,0.5389453481338661,113,50,25,29,6,4,36,21,37,59
"sgc_coral-anthropic10,sgc_coral-gemini2510,sgc_coral-openai4510","4,2,1",0.5865384615384616,0.4857634129951128,0.6822542462493977,104,61,0.5575221238938053,0.4610546518661339,0.6508999553070312,113,63,34,46,15,8,27,17,28,42
"sgc_coral-anthropic3710,sgc_coral-gemini10,sgc_coral-geminipro","3,4,1",0.5865384615384616,0.4857634129951128,0.6822542462493977,104,61,0.4424778761061947,0.3491000446929689,0.5389453481338661,113,50,28,33,9,8,33,17,34,55
"sgc_coral-anthropic,sgc_coral-openai10,sgc_coral-openaio1","1,1,2",0.5865384615384616,0.4857634129951128,0.6822542462493977,104,61,0.5309734513274337,0.4347936889763754,0.6254900011303783,113,60,32,41,13,6,29,19,30,47
"sgc_coral-anthropic10,sgc_coral-geminipro,sgc_coral-geminipro10","4,1,1",0.5865384615384616,0.4857634129951128,0.6822542462493977,104,61,0.45132743362831856,0.35754135758362804,0.5477275431896468,113,51,30,37,11,11,31,14,32,51
"sgc_coral-gemini,sgc_coral-gemini25,sgc_coral-openailong","1,2,3",0.5865384615384616,0.4857634129951128,0.6822542462493977,104,61,0.415929203539823,0.3239503340286666,0.5124256476840243,113,47,29,27,10,5,32,20,33,61
"sgc_coral-openai4510,sgc_coral-openailong,sgc_coral-openaio1","1,3,2",0.5865384615384616,0.4857634129951128,0.6822542462493977,104,61,0.5575221238938053,0.4610546518661339,0.6508999553070312,113,63,28,43,9,5,33,20,34,45
"sgc_coral-gemini25,sgc_coral-gemini2510,sgc_coral-openai10o1","2,2,1",0.5865384615384616,0.4857634129951128,0.6822542462493977,104,61,0.4424778761061947,0.3491000446929689,0.5389453481338661,113,50,31,34,12,9,30,16,31,54
"sgc_coral-anthropic3710,sgc_coral-geminipro,sgc_coral-openai10o1","3,1,1",0.5865384615384616,0.4857634129951128,0.6822542462493977,104,61,0.5221238938053098,0.4260969019985035,0.6169629390023114,113,59,39,45,20,11,22,14,23,43
"sgc_coral-anthropic37,sgc_coral-gemini25,sgc_coral-geminipro10","7,2,1",0.5865384615384616,0.4857634129951128,0.6822542462493977,104,61,0.39823008849557523,0.30733148555269946,0.4945994395519369,113,45,22,22,3,2,39,23,40,66
"sgc_coral-anthropic37,sgc_coral-gemini2510,sgc_coral-openai4510","7,2,1",0.5865384615384616,0.4857634129951128,0.6822542462493977,104,61,0.5309734513274337,0.4347936889763754,0.6254900011303783,113,60,32,43,13,8,29,17,30,45
"sgc_coral-geminipro,sgc_coral-geminipro10,sgc_coral-openaio1","1,1,2",0.5865384615384616,0.4857634129951128,0.6822542462493977,104,61,0.5221238938053098,0.4260969019985035,0.6169629390023114,113,59,30,42,11,8,31,17,32,46
"sgc_coral-gemini2510,sgc_coral-openai,sgc_coral-openaio1","2,1,2",0.5865384615384616,0.4857634129951128,0.6822542462493977,104,61,0.6017699115044248,0.5054005604480631,0.6926685144473006,113,68,33,50,14,7,28,18,29,38
"sgc_coral-geminipro10,sgc_coral-gemma,sgc_coral-openaio1","1,1,2",0.5865384615384616,0.4857634129951128,0.6822542462493977,104,61,0.5221238938053098,0.4260969019985035,0.6169629390023114,113,59,29,44,10,10,32,15,33,44
"sgc_coral-anthropic,sgc_coral-anthropic3710,sgc_coral-openai10o1","1,3,1",0.5865384615384616,0.4857634129951128,0.6822542462493977,104,61,0.4778761061946903,0.38303706099768864,0.5739030980014965,113,54,36,41,17,12,25,13,26,47
"sgc_coral-anthropic,sgc_coral-anthropic3710,sgc_coral-gemini25","1,3,2",0.5865384615384616,0.4857634129951128,0.6822542462493977,104,61,0.4424778761061947,0.3491000446929689,0.5389453481338661,113,50,30,31,11,6,31,19,32,57
"sgc_coral-anthropic37,sgc_coral-geminipro,sgc_coral-geminipro10","7,1,1",0.5865384615384616,0.4857634129951128,0.6822542462493977,104,61,0.46017699115044247,0.3660113913185952,0.5564811572428492,113,52,31,36,12,9,30,16,31,52
"sgc_coral-anthropic,sgc_coral-gemini10,sgc_coral-openailong","1,4,3",0.5865384615384616,0.4857634129951128,0.6822542462493977,104,61,0.45132743362831856,0.35754135758362804,0.5477275431896468,113,51,28,32,9,6,33,19,34,56
"sgc_coral-gemini2510,sgc_coral-gemma,sgc_coral-openai45","2,1,1",0.5865384615384616,0.4857634129951128,0.6822542462493977,104,61,0.6548672566371682,0.559609451034119,0.7417860268897711,113,74,42,62,23,13,19,12,20,26
"sgc_coral-anthropic,sgc_coral-anthropic3710,sgc_coral-gemini10","1,3,4",0.5865384615384616,0.4857634129951128,0.6822542462493977,104,61,0.48672566371681414,0.391592485688175,0.5825715848269355,113,55,30,37,11,7,31,18,32,51
"sgc_coral-anthropic,sgc_coral-gemini25,sgc_coral-geminipro10","1,2,1",0.5865384615384616,0.4857634129951128,0.6822542462493977,104,61,0.415929203539823,0.3239503340286666,0.5124256476840243,113,47,29,29,10,7,32,18,33,59
"sgc_coral-gemma,sgc_coral-openai10,sgc_coral-openai45","1,1,1",0.5865384615384616,0.4857634129951128,0.6822542462493977,104,61,0.5486725663716814,0.4522724568103532,0.642458642416372,113,62,40,51,21,14,21,11,22,37
"sgc_coral-anthropic,sgc_coral-anthropic37,sgc_coral-gemma","1,7,1",0.5865384615384616,0.4857634129951128,0.6822542462493977,104,61,0.49557522123893805,0.40017620771878704,0.5912118116445175,113,56,32,39,13,8,29,17,30,49
"sgc_coral-gemma,sgc_coral-openai10,sgc_coral-openaio1","1,1,2",0.5865384615384616,0.4857634129951128,0.6822542462493977,104,61,0.5398230088495575,0.44351884275715087,0.6339886086814048,113,61,30,45,11,9,31,16,32,43
"sgc_coral-gemini2510,sgc_coral-geminipro,sgc_coral-openai45","2,1,1",0.5865384615384616,0.4857634129951128,0.6822542462493977,104,61,0.6194690265486725,0.5233464844783339,0.7091663790724447,113,70,42,58,23,13,19,12,20,30
"sgc_coral-anthropic10,sgc_coral-openai45,sgc_coral-openai4510","4,1,1",0.5865384615384616,0.4857634129951128,0.6822542462493977,104,61,0.5132743362831859,0.41742841517306456,0.608407514311825,113,58,30,44,11,11,31,14,32,44
"sgc_coral-anthropic37,sgc_coral-geminipro10,sgc_coral-openai45","7,1,1",0.5865384615384616,0.4857634129951128,0.6822542462493977,104,61,0.4778761061946903,0.38303706099768864,0.5739030980014965,113,54,29,38,10,9,32,16,33,50
"sgc_coral-anthropic,sgc_coral-anthropic10,sgc_coral-gemma","1,4,1",0.5865384615384616,0.4857634129951128,0.6822542462493977,104,61,0.5486725663716814,0.4522724568103532,0.642458642416372,113,62,32,47,13,10,29,15,30,41
"sgc_coral-anthropic,sgc_coral-gemini2510,sgc_coral-openai","1,2,1",0.5865384615384616,0.4857634129951128,0.6822542462493977,104,61,0.5929203539823009,0.4964726470054805,0.6843740416228519,113,67,41,53,22,11,20,14,21,35
"sgc_coral-gemini2510,sgc_coral-openai10o1,sgc_coral-openai4510","2,1,1",0.5865384615384616,0.4857634129951128,0.6822542462493977,104,61,0.5221238938053098,0.4260969019985035,0.6169629390023114,113,59,39,47,20,13,22,12,23,41
"sgc_coral-gemma,sgc_coral-openai4510,sgc_coral-openailong","1,1,3",0.5865384615384616,0.4857634129951128,0.6822542462493977,104,61,0.5221238938053098,0.4260969019985035,0.6169629390023114,113,59,32,43,13,9,29,16,30,45
"sgc_coral-anthropic3710,sgc_coral-openai,sgc_coral-openai4510","3,1,1",0.5769230769230769,0.4761306379501743,0.6732192386138718,104,60,0.5752212389380531,0.4787054077974483,0.6676956871258655,113,65,37,49,19,9,23,16,25,39
"sgc_coral-anthropic10,sgc_coral-anthropic37,sgc_coral-openai10o1","4,7,1",0.5769230769230769,0.4761306379501743,0.6732192386138718,104,60,0.45132743362831856,0.35754135758362804,0.5477275431896468,113,51,23,31,5,5,37,20,39,57
"sgc_coral-anthropic3710,sgc_coral-gemma,sgc_coral-openaio1","3,1,2",0.5769230769230769,0.4761306379501743,0.6732192386138718,104,60,0.5663716814159292,0.4698655764900294,0.6593123718320077,113,64,30,48,12,9,30,16,32,40
"sgc_coral-gemini,sgc_coral-gemini10,sgc_coral-openai10","1,4,1",0.5769230769230769,0.4761306379501743,0.6732192386138718,104,60,0.4247787610619469,0.33230431287413453,0.5212945922025517,113,48,33,29,15,6,27,19,29,59
"sgc_coral-anthropic,sgc_coral-anthropic37,sgc_coral-geminipro10","1,7,1",0.5769230769230769,0.4761306379501743,0.6732192386138718,104,60,0.4690265486725664,0.3745099988696216,0.5652063110236246,113,53,28,35,10,7,32,18,34,53
"sgc_coral-openai,sgc_coral-openai10,sgc_coral-openai45","1,1,1",0.5769230769230769,0.4761306379501743,0.6732192386138718,104,60,0.584070796460177,0.4875743523159756,0.6760496659713334,113,66,41,51,23,10,19,15,21,37
"sgc_coral-openai,sgc_coral-openai45,sgc_coral-openailong","1,1,3",0.5769230769230769,0.4761306379501743,0.6732192386138718,104,60,0.5575221238938053,0.4610546518661339,0.6508999553070312,113,63,37,48,19,10,23,15,25,40
"sgc_coral-openai10,sgc_coral-openai10o1,sgc_coral-openaio1","1,1,2",0.5769230769230769,0.4761306379501743,0.6732192386138718,104,60,0.5221238938053098,0.4260969019985035,0.6169629390023114,113,59,31,41,13,7,29,18,31,47
"sgc_coral-openai10o1,sgc_coral-openailong,sgc_coral-openaio1","1,3,2",0.5769230769230769,0.4761306379501743,0.6732192386138718,104,60,0.5221238938053098,0.4260969019985035,0.6169629390023114,113,59,27,40,9,6,33,19,35,48
"sgc_coral-anthropic10,sgc_coral-gemini,sgc_coral-gemma","4,1,1",0.5769230769230769,0.4761306379501743,0.6732192386138718,104,60,0.4690265486725664,0.3745099988696216,0.5652063110236246,113,53,31,37,13,9,29,16,31,51
"sgc_coral-anthropic10,sgc_coral-gemini,sgc_coral-openai10","4,1,1",0.5769230769230769,0.4761306379501743,0.6732192386138718,104,60,0.5221238938053098,0.4260969019985035,0.6169629390023114,113,59,33,40,15,6,27,19,29,48
"sgc_coral-gemini,sgc_coral-gemini2510,sgc_coral-openai4510","1,2,1",0.5769230769230769,0.4761306379501743,0.6732192386138718,104,60,0.6460176991150443,0.5504962136889733,0.7336793311699545,113,73,40,57,22,9,20,16,22,31
"sgc_coral-gemini25,sgc_coral-geminipro,sgc_coral-openailong","2,1,3",0.5769230769230769,0.4761306379501743,0.6732192386138718,104,60,0.45132743362831856,0.35754135758362804,0.5477275431896468,113,51,28,33,10,7,32,18,34,55
"sgc_coral-anthropic,sgc_coral-openai,sgc_coral-openailong","1,1,3",0.5769230769230769,0.4761306379501743,0.6732192386138718,104,60,0.504424778761062,0.4087881883554824,0.599823792281213,113,57,35,39,17,7,25,18,27,49
"sgc_coral-gemini,sgc_coral-geminipro10,sgc_coral-openai10o1","1,1,1",0.5769230769230769,0.4761306379501743,0.6732192386138718,104,60,0.45132743362831856,0.35754135758362804,0.5477275431896468,113,51,37,38,19,12,23,13,25,50
"sgc_coral-gemini25,sgc_coral-geminipro10,sgc_coral-openai","2,1,1",0.5769230769230769,0.4761306379501743,0.6732192386138718,104,60,0.36283185840707965,0.2744598598768483,0.4585850370789202,113,41,28,22,10,6,32,19,34,66
"sgc_coral-anthropic,sgc_coral-geminipro10,sgc_coral-gemma","1,1,1",0.5769230769230769,0.4761306379501743,0.6732192386138718,104,60,0.5132743362831859,0.41742841517306456,0.608407514311825,113,58,38,46,20,13,22,12,24,42
"sgc_coral-gemini25,sgc_coral-openai10,sgc_coral-openai10o1","2,1,1",0.5769230769230769,0.4761306379501743,0.6732192386138718,104,60,0.415929203539823,0.3239503340286666,0.5124256476840243,113,47,28,30,10,8,32,17,34,58
"sgc_coral-gemini25,sgc_coral-gemini2510,sgc_coral-openai","2,2,1",0.5769230769230769,0.4761306379501743,0.6732192386138718,104,60,0.5221238938053098,0.4260969019985035,0.6169629390023114,113,59,30,40,12,6,30,19,32,48
"sgc_coral-gemini25,sgc_coral-gemini2510,sgc_coral-gemma","2,2,1",0.5769230769230769,0.4761306379501743,0.6732192386138718,104,60,0.5309734513274337,0.4347936889763754,0.6254900011303783,113,60,30,43,12,8,30,17,32,45
"sgc_coral-gemini10,sgc_coral-openailong,sgc_coral-openaio1","4,3,2",0.5769230769230769,0.4761306379501743,0.6732192386138718,104,60,0.4778761061946903,0.38303706099768864,0.5739030980014965,113,54,23,34,5,5,37,20,39,54
"sgc_coral-gemini10,sgc_coral-openai10,sgc_coral-openai10o1","4,1,1",0.5769230769230769,0.4761306379501743,0.6732192386138718,104,60,0.4247787610619469,0.33230431287413453,0.5212945922025517,113,48,28,31,10,8,32,17,34,57
"sgc_coral-gemini2510,sgc_coral-geminipro,sgc_coral-openai10o1","2,1,1",0.5769230769230769,0.4761306379501743,0.6732192386138718,104,60,0.5575221238938053,0.4610546518661339,0.6508999553070312,113,63,40,51,22,13,20,12,22,37
"sgc_coral-gemini10,sgc_coral-geminipro10,sgc_coral-openailong","4,1,3",0.5769230769230769,0.4761306379501743,0.6732192386138718,104,60,0.46017699115044247,0.3660113913185952,0.5564811572428492,113,52,26,32,8,5,34,20,36,56
"sgc_coral-gemini10,sgc_coral-geminipro,sgc_coral-openai10","4,1,1",0.5769230769230769,0.4761306379501743,0.6732192386138718,104,60,0.45132743362831856,0.35754135758362804,0.5477275431896468,113,51,31,33,13,7,29,18,31,55
"sgc_coral-gemini10,sgc_coral-gemini2510,sgc_coral-openaio1","4,2,2",0.5769230769230769,0.4761306379501743,0.6732192386138718,104,60,0.5221238938053098,0.4260969019985035,0.6169629390023114,113,59,24,40,6,6,36,19,38,48
"sgc_coral-gemini10,sgc_coral-gemini2510,sgc_coral-gemma","4,2,1",0.5769230769230769,0.4761306379501743,0.6732192386138718,104,60,0.5221238938053098,0.4260969019985035,0.6169629390023114,113,59,28,43,10,9,32,16,34,45
"sgc_coral-anthropic,sgc_coral-gemini2510,sgc_coral-geminipro","1,2,1",0.5769230769230769,0.4761306379501743,0.6732192386138718,104,60,0.584070796460177,0.4875743523159756,0.6760496659713334,113,66,41,53,23,12,19,13,21,35
"sgc_coral-anthropic,sgc_coral-gemini25,sgc_coral-openailong","1,2,3",0.5769230769230769,0.4761306379501743,0.6732192386138718,104,60,0.4247787610619469,0.33230431287413453,0.5212945922025517,113,48,27,29,9,6,33,19,35,59
"sgc_coral-gemini2510,sgc_coral-geminipro10,sgc_coral-openai","2,1,1",0.5769230769230769,0.4761306379501743,0.6732192386138718,104,60,0.5575221238938053,0.4610546518661339,0.6508999553070312,113,63,40,50,22,12,20,13,22,38
"sgc_coral-gemini10,sgc_coral-gemini2510,sgc_coral-geminipro","4,2,1",0.5769230769230769,0.4761306379501743,0.6732192386138718,104,60,0.49557522123893805,0.40017620771878704,0.5912118116445175,113,56,32,40,14,9,28,16,30,48
"sgc_coral-gemini2510,sgc_coral-gemma,sgc_coral-openai10o1","2,1,1",0.5769230769230769,0.4761306379501743,0.6732192386138718,104,60,0.5486725663716814,0.4522724568103532,0.642458642416372,113,62,37,51,19,14,23,11,25,37
"sgc_coral-gemini,sgc_coral-openai4510,sgc_coral-openailong","1,1,3",0.5769230769230769,0.4761306379501743,0.6732192386138718,104,60,0.5486725663716814,0.4522724568103532,0.642458642416372,113,62,35,44,17,7,25,18,27,44
"sgc_coral-anthropic,sgc_coral-openai,sgc_coral-openai10","1,1,1",0.5769230769230769,0.4761306379501743,0.6732192386138718,104,60,0.5132743362831859,0.41742841517306456,0.608407514311825,113,58,39,42,21,9,21,16,23,46
"sgc_coral-gemini,sgc_coral-gemma,sgc_coral-openai10","1,1,1",0.5769230769230769,0.4761306379501743,0.6732192386138718,104,60,0.5132743362831859,0.41742841517306456,0.608407514311825,113,58,38,46,20,13,22,12,24,42
"sgc_coral-gemini25,sgc_coral-geminipro,sgc_coral-openai10","2,1,1",0.5769230769230769,0.4761306379501743,0.6732192386138718,104,60,0.45132743362831856,0.35754135758362804,0.5477275431896468,113,51,33,33,15,7,27,18,29,55
"sgc_coral-anthropic,sgc_coral-gemini10,sgc_coral-openai10","1,4,1",0.5769230769230769,0.4761306379501743,0.6732192386138718,104,60,0.46017699115044247,0.3660113913185952,0.5564811572428492,113,52,30,33,12,6,30,19,32,55
"sgc_coral-gemini10,sgc_coral-geminipro,sgc_coral-geminipro10","4,1,1",0.5769230769230769,0.4761306379501743,0.6732192386138718,104,60,0.3805309734513274,0.2908336209275553,0.4766535155216661,113,43,28,28,10,10,32,15,34,60
"sgc_coral-anthropic3710,sgc_coral-gemini,sgc_coral-openai","3,1,1",0.5769230769230769,0.4761306379501743,0.6732192386138718,104,60,0.584070796460177,0.4875743523159756,0.6760496659713334,113,66,35,48,17,7,25,18,27,40
"sgc_coral-anthropic37,sgc_coral-anthropic3710,sgc_coral-openaio1","7,3,2",0.5769230769230769,0.4761306379501743,0.6732192386138718,104,60,0.504424778761062,0.4087881883554824,0.599823792281213,113,57,26,36,8,4,34,21,36,52
"sgc_coral-anthropic37,sgc_coral-gemini25,sgc_coral-openai10","7,2,1",0.5769230769230769,0.4761306379501743,0.6732192386138718,104,60,0.36283185840707965,0.2744598598768483,0.4585850370789202,113,41,24,18,6,2,36,23,38,70
"sgc_coral-anthropic10,sgc_coral-openai45,sgc_coral-openaio1","4,1,2",0.5769230769230769,0.4761306379501743,0.6732192386138718,104,60,0.5221238938053098,0.4260969019985035,0.6169629390023114,113,59,24,40,6,6,36,19,38,48
"sgc_coral-anthropic3710,sgc_coral-gemini25,sgc_coral-openaio1","3,2,2",0.5769230769230769,0.4761306379501743,0.6732192386138718,104,60,0.45132743362831856,0.35754135758362804,0.5477275431896468,113,51,24,30,6,4,36,21,38,58
"sgc_coral-anthropic37,sgc_coral-openai,sgc_coral-openai10","7,1,1",0.5769230769230769,0.4761306379501743,0.6732192386138718,104,60,0.48672566371681414,0.391592485688175,0.5825715848269355,113,55,32,36,14,6,28,19,30,52
"sgc_coral-anthropic37,sgc_coral-gemini,sgc_coral-openai10o1","7,1,1",0.5673076923076923,0.46653366165172977,0.6641481278822257,104,59,0.45132743362831856,0.35754135758362804,0.5477275431896468,113,51,29,35,12,9,30,16,33,53
"sgc_coral-anthropic10,sgc_coral-geminipro10,sgc_coral-openaio1","4,1,2",0.5673076923076923,0.46653366165172977,0.6641481278822257,104,59,0.45132743362831856,0.35754135758362804,0.5477275431896468,113,51,20,30,3,4,39,21,42,58
"sgc_coral-geminipro10,sgc_coral-gemma,sgc_coral-openai10o1","1,1,1",0.5673076923076923,0.46653366165172977,0.6641481278822257,104,59,0.4778761061946903,0.38303706099768864,0.5739030980014965,113,54,34,42,17,13,25,12,28,46
"sgc_coral-gemini,sgc_coral-openai10o1,sgc_coral-openailong","1,1,3",0.5673076923076923,0.46653366165172977,0.6641481278822257,104,59,0.4778761061946903,0.38303706099768864,0.5739030980014965,113,54,36,39,19,10,23,15,26,49
"sgc_coral-anthropic10,sgc_coral-geminipro10,sgc_coral-openai45","4,1,1",0.5673076923076923,0.46653366165172977,0.6641481278822257,104,59,0.46017699115044247,0.3660113913185952,0.5564811572428492,113,52,28,39,11,12,31,13,34,49
"sgc_coral-gemini,sgc_coral-openai10,sgc_coral-openai4510","1,1,1",0.5673076923076923,0.46653366165172977,0.6641481278822257,104,59,0.48672566371681414,0.391592485688175,0.5825715848269355,113,55,39,40,22,10,20,15,23,48
"sgc_coral-gemini,sgc_coral-openai10,sgc_coral-openai10o1","1,1,1",0.5673076923076923,0.46653366165172977,0.6641481278822257,104,59,0.4778761061946903,0.38303706099768864,0.5739030980014965,113,54,38,40,21,11,21,14,24,48
"sgc_coral-anthropic37,sgc_coral-gemini10,sgc_coral-geminipro10","7,4,1",0.5673076923076923,0.46653366165172977,0.6641481278822257,104,59,0.3893805309734513,0.29906724963482817,0.48564160577774956,113,44,20,21,3,2,39,23,42,67
"sgc_coral-anthropic,sgc_coral-anthropic3710,sgc_coral-openai","1,3,1",0.5673076923076923,0.46653366165172977,0.6641481278822257,104,59,0.49557522123893805,0.40017620771878704,0.5912118116445175,113,56,36,41,19,10,23,15,26,47
"sgc_coral-anthropic37,sgc_coral-openai45,sgc_coral-openai4510","7,1,1",0.5673076923076923,0.46653366165172977,0.6641481278822257,104,59,0.504424778761062,0.4087881883554824,0.599823792281213,113,57,27,41,10,9,32,16,35,47
"sgc_coral-anthropic10,sgc_coral-geminipro10,sgc_coral-openai","4,1,1",0.5673076923076923,0.46653366165172977,0.6641481278822257,104,59,0.4336283185840708,0.3406876281679922,0.5301344235099705,113,49,29,32,12,8,30,17,33,56
"sgc_coral-anthropic37,sgc_coral-gemini25,sgc_coral-openai45","7,2,1",0.5673076923076923,0.46653366165172977,0.6641481278822257,104,59,0.4336283185840708,0.3406876281679922,0.5301344235099705,113,49,21,27,4,3,38,22,41,61
"sgc_coral-anthropic10,sgc_coral-geminipro10,sgc_coral-gemma","4,1,1",0.5673076923076923,0.46653366165172977,0.6641481278822257,104,59,0.48672566371681414,0.391592485688175,0.5825715848269355,113,55,29,40,12,10,30,15,33,48
"sgc_coral-gemini,sgc_coral-gemini25,sgc_coral-openai45","1,2,1",0.5673076923076923,0.46653366165172977,0.6641481278822257,104,59,0.4690265486725664,0.3745099988696216,0.5652063110236246,113,53,30,37,13,9,29,16,32,51
"sgc_coral-gemini,sgc_coral-gemini25,sgc_coral-openai10","1,2,1",0.5673076923076923,0.46653366165172977,0.6641481278822257,104,59,0.415929203539823,0.3239503340286666,0.5124256476840243,113,47,33,27,16,5,26,20,29,61
"sgc_coral-gemini,sgc_coral-gemini10,sgc_coral-openailong","1,4,3",0.5673076923076923,0.46653366165172977,0.6641481278822257,104,59,0.46017699115044247,0.3660113913185952,0.5564811572428492,113,52,27,32,10,5,32,20,35,56
"sgc_coral-anthropic,sgc_coral-anthropic37,sgc_coral-gemini10","1,7,4",0.5673076923076923,0.46653366165172977,0.6641481278822257,104,59,0.40707964601769914,0.3156259583771482,0.5035273529945195,113,46,22,23,5,2,37,23,40,65
"sgc_coral-geminipro,sgc_coral-openailong,sgc_coral-openaio1","1,3,2",0.5673076923076923,0.46653366165172977,0.6641481278822257,104,59,0.5221238938053098,0.4260969019985035,0.6169629390023114,113,59,29,41,12,7,30,18,33,47
"sgc_coral-gemini10,sgc_coral-geminipro10,sgc_coral-openai","4,1,1",0.5673076923076923,0.46653366165172977,0.6641481278822257,104,59,0.35398230088495575,0.26632066883004546,0.44950378631102667,113,40,27,22,10,7,32,18,35,66
"sgc_coral-gemini10,sgc_coral-gemini2510,sgc_coral-openai10o1","4,2,1",0.5673076923076923,0.46653366165172977,0.6641481278822257,104,59,0.45132743362831856,0.35754135758362804,0.5477275431896468,113,51,30,35,13,9,29,16,32,53
"sgc_coral-gemini10,sgc_coral-geminipro10,sgc_coral-gemma","4,1,1",0.5673076923076923,0.46653366165172977,0.6641481278822257,104,59,0.39823008849557523,0.30733148555269946,0.4945994395519369,113,45,28,30,11,10,31,15,34,58
"sgc_coral-gemini25,sgc_coral-openai10,sgc_coral-openai4510","2,1,1",0.5673076923076923,0.46653366165172977,0.6641481278822257,104,59,0.4424778761061947,0.3491000446929689,0.5389453481338661,113,50,29,31,12,6,30,19,33,57
"sgc_coral-gemini25,sgc_coral-gemma,sgc_coral-openai10","2,1,1",0.5673076923076923,0.46653366165172977,0.6641481278822257,104,59,0.46017699115044247,0.3660113913185952,0.5564811572428492,113,52,31,35,14,8,28,17,31,53
"sgc_coral-anthropic,sgc_coral-gemini2510,sgc_coral-openaio1","1,2,2",0.5673076923076923,0.46653366165172977,0.6641481278822257,104,59,0.5929203539823009,0.4964726470054805,0.6843740416228519,113,67,35,49,18,7,24,18,27,39
"sgc_coral-gemini2510,sgc_coral-geminipro,sgc_coral-gemma","2,1,1",0.5673076923076923,0.46653366165172977,0.6641481278822257,104,59,0.6283185840707964,0.5323652037350549,0.717368992019971,113,71,41,59,24,13,18,12,21,29
"sgc_coral-anthropic10,sgc_coral-openai,sgc_coral-openaio1","4,1,2",0.5673076923076923,0.46653366165172977,0.6641481278822257,104,59,0.5132743362831859,0.41742841517306456,0.608407514311825,113,58,23,37,6,4,36,21,39,51
"sgc_coral-anthropic10,sgc_coral-gemini25,sgc_coral-geminipro10","4,2,1",0.5673076923076923,0.46653366165172977,0.6641481278822257,104,59,0.37168141592920356,0.28263100798002905,0.4676347962649451,113,42,20,21,3,4,39,21,42,67
"sgc_coral-gemini25,sgc_coral-geminipro,sgc_coral-geminipro10","2,1,1",0.5673076923076923,0.46653366165172977,0.6641481278822257,104,59,0.3893805309734513,0.29906724963482817,0.48564160577774956,113,44,28,28,11,9,31,16,34,60
"sgc_coral-anthropic37,sgc_coral-geminipro10,sgc_coral-gemma","7,1,1",0.5673076923076923,0.46653366165172977,0.6641481278822257,104,59,0.45132743362831856,0.35754135758362804,0.5477275431896468,113,51,28,34,11,8,31,17,34,54
"sgc_coral-anthropic37,sgc_coral-geminipro,sgc_coral-openai4510","7,1,1",0.5673076923076923,0.46653366165172977,0.6641481278822257,104,59,0.4424778761061947,0.3491000446929689,0.5389453481338661,113,50,26,32,9,7,33,18,36,56
"sgc_coral-anthropic37,sgc_coral-geminipro,sgc_coral-openai10o1","7,1,1",0.5673076923076923,0.46653366165172977,0.6641481278822257,104,59,0.504424778761062,0.4087881883554824,0.599823792281213,113,57,32,37,15,5,27,20,30,51
"sgc_coral-anthropic,sgc_coral-geminipro10,sgc_coral-openaio1","1,1,2",0.5673076923076923,0.46653366165172977,0.6641481278822257,104,59,0.504424778761062,0.4087881883554824,0.599823792281213,113,57,29,39,12,7,30,18,33,49
"sgc_coral-gemini10,sgc_coral-openai10,sgc_coral-openai4510","4,1,1",0.5673076923076923,0.46653366165172977,0.6641481278822257,104,59,0.45132743362831856,0.35754135758362804,0.5477275431896468,113,51,27,34,10,8,32,17,35,54
"sgc_coral-gemini2510,sgc_coral-gemma,sgc_coral-openai4510","2,1,1",0.5673076923076923,0.46653366165172977,0.6641481278822257,104,59,0.5929203539823009,0.4964726470054805,0.6843740416228519,113,67,35,54,18,12,24,13,27,34
"sgc_coral-gemini2510,sgc_coral-openai,sgc_coral-openai10o1","2,1,1",0.5673076923076923,0.46653366165172977,0.6641481278822257,104,59,0.5398230088495575,0.44351884275715087,0.6339886086814048,113,61,38,47,21,11,21,14,24,41
"sgc_coral-gemini10,sgc_coral-gemma,sgc_coral-openai10","4,1,1",0.5673076923076923,0.46653366165172977,0.6641481278822257,104,59,0.48672566371681414,0.391592485688175,0.5825715848269355,113,55,30,39,13,9,29,16,32,49
"sgc_coral-anthropic37,sgc_coral-openai10o1,sgc_coral-openai45","7,1,1",0.5673076923076923,0.46653366165172977,0.6641481278822257,104,59,0.48672566371681414,0.391592485688175,0.5825715848269355,113,55,29,38,12,8,30,17,33,50
"sgc_coral-anthropic,sgc_coral-openailong,sgc_coral-openaio1","1,3,2",0.5673076923076923,0.46653366165172977,0.6641481278822257,104,59,0.504424778761062,0.4087881883554824,0.599823792281213,113,57,30,37,13,5,29,20,32,51
"sgc_coral-openai10,sgc_coral-openai10o1,sgc_coral-openai4510","1,1,1",0.5673076923076923,0.46653366165172977,0.6641481278822257,104,59,0.48672566371681414,0.391592485688175,0.5825715848269355,113,55,36,43,19,13,23,12,26,45
"sgc_coral-gemini,sgc_coral-openai10,sgc_coral-openai45","1,1,1",0.5673076923076923,0.46653366165172977,0.6641481278822257,104,59,0.5221238938053098,0.4260969019985035,0.6169629390023114,113,59,40,47,23,13,19,12,22,41
"sgc_coral-anthropic10,sgc_coral-gemini,sgc_coral-openai4510","4,1,1",0.5673076923076923,0.46653366165172977,0.6641481278822257,104,59,0.5309734513274337,0.4347936889763754,0.6254900011303783,113,60,29,42,12,7,30,18,33,46
"sgc_coral-anthropic10,sgc_coral-gemini10,sgc_coral-openailong","4,4,3",0.5673076923076923,0.46653366165172977,0.6641481278822257,104,59,0.415929203539823,0.3239503340286666,0.5124256476840243,113,47,24,29,7,7,35,18,38,59
"sgc_coral-anthropic3710,sgc_coral-gemini25,sgc_coral-openai10o1","3,2,1",0.5673076923076923,0.46653366165172977,0.6641481278822257,104,59,0.4247787610619469,0.33230431287413453,0.5212945922025517,113,48,26,29,9,6,33,19,36,59
"sgc_coral-anthropic10,sgc_coral-gemini25,sgc_coral-openai45","4,2,1",0.5673076923076923,0.46653366165172977,0.6641481278822257,104,59,0.4424778761061947,0.3491000446929689,0.5389453481338661,113,50,22,29,5,4,37,21,40,59
"sgc_coral-anthropic10,sgc_coral-gemini,sgc_coral-geminipro10","4,1,1",0.5673076923076923,0.46653366165172977,0.6641481278822257,104,59,0.46017699115044247,0.3660113913185952,0.5564811572428492,113,52,28,36,11,9,31,16,34,52
"sgc_coral-anthropic37,sgc_coral-gemini10,sgc_coral-openai10","7,4,1",0.5673076923076923,0.46653366165172977,0.6641481278822257,104,59,0.34513274336283184,0.2582139731102288,0.44039054896588103,113,39,22,17,5,3,37,22,40,71
"sgc_coral-anthropic3710,sgc_coral-gemma,sgc_coral-openai45","3,1,1",0.5673076923076923,0.46653366165172977,0.6641481278822257,104,59,0.5663716814159292,0.4698655764900294,0.6593123718320077,113,64,37,52,20,13,22,12,25,36
"sgc_coral-anthropic3710,sgc_coral-openai,sgc_coral-openai10o1","3,1,1",0.5673076923076923,0.46653366165172977,0.6641481278822257,104,59,0.48672566371681414,0.391592485688175,0.5825715848269355,113,55,36,41,19,11,23,14,26,47
"sgc_coral-anthropic3710,sgc_coral-gemini10,sgc_coral-openai10o1","3,4,1",0.5673076923076923,0.46653366165172977,0.6641481278822257,104,59,0.4336283185840708,0.3406876281679922,0.5301344235099705,113,49,25,32,8,8,34,17,37,56
"sgc_coral-anthropic10,sgc_coral-gemini10,sgc_coral-gemma","4,4,1",0.5673076923076923,0.46653366165172977,0.6641481278822257,104,59,0.3893805309734513,0.29906724963482817,0.48564160577774956,113,44,21,25,4,6,38,19,41,63
"sgc_coral-anthropic3710,sgc_coral-openai,sgc_coral-openai45","3,1,1",0.5673076923076923,0.46653366165172977,0.6641481278822257,104,59,0.5663716814159292,0.4698655764900294,0.6593123718320077,113,64,37,50,20,11,22,14,25,38
"sgc_coral-anthropic10,sgc_coral-gemini10,sgc_coral-openai10o1","4,4,1",0.5673076923076923,0.46653366165172977,0.6641481278822257,104,59,0.3893805309734513,0.29906724963482817,0.48564160577774956,113,44,22,23,5,4,37,21,40,65
"sgc_coral-anthropic3710,sgc_coral-gemini10,sgc_coral-openaio1","3,4,2",0.5673076923076923,0.46653366165172977,0.6641481278822257,104,59,0.4778761061946903,0.38303706099768864,0.5739030980014965,113,54,23,33,6,4,36,21,39,55
"sgc_coral-gemini10,sgc_coral-gemini25,sgc_coral-openai4510","4,2,1",0.5576923076923077,0.4569722043865908,0.6550412354355004,104,58,0.34513274336283184,0.2582139731102288,0.44039054896588103,113,39,20,19,4,5,38,20,42,69
"sgc_coral-geminipro,sgc_coral-openai45,sgc_coral-openailong","1,1,3",0.5576923076923077,0.4569722043865908,0.6550412354355004,104,58,0.5663716814159292,0.4698655764900294,0.6593123718320077,113,64,38,48,22,9,20,16,24,40
"sgc_coral-gemini10,sgc_coral-gemini25,sgc_coral-gemini2510","4,2,2",0.5576923076923077,0.4569722043865908,0.6550412354355004,104,58,0.3893805309734513,0.29906724963482817,0.48564160577774956,113,44,23,24,7,5,35,20,39,64
"sgc_coral-anthropic10,sgc_coral-gemini10,sgc_coral-openai45","4,4,1",0.5576923076923077,0.4569722043865908,0.6550412354355004,104,58,0.4247787610619469,0.33230431287413453,0.5212945922025517,113,48,20,28,4,5,38,20,42,60
"sgc_coral-geminipro,sgc_coral-openai10,sgc_coral-openai45","1,1,1",0.5576923076923077,0.4569722043865908,0.6550412354355004,104,58,0.5398230088495575,0.44351884275715087,0.6339886086814048,113,61,37,48,21,12,21,13,25,40
"sgc_coral-openai10,sgc_coral-openai45,sgc_coral-openai4510","1,1,1",0.5576923076923077,0.4569722043865908,0.6550412354355004,104,58,0.5398230088495575,0.44351884275715087,0.6339886086814048,113,61,37,49,21,13,21,12,25,39
"sgc_coral-gemini,sgc_coral-openai10o1,sgc_coral-openaio1","1,1,2",0.5576923076923077,0.4569722043865908,0.6550412354355004,104,58,0.5132743362831859,0.41742841517306456,0.608407514311825,113,58,30,41,14,8,28,17,32,47
"sgc_coral-anthropic,sgc_coral-gemma,sgc_coral-openaio1","1,1,2",0.5576923076923077,0.4569722043865908,0.6550412354355004,104,58,0.5486725663716814,0.4522724568103532,0.642458642416372,113,62,32,47,16,10,26,15,30,41
"sgc_coral-anthropic10,sgc_coral-gemini,sgc_coral-gemini10","4,1,4",0.5576923076923077,0.4569722043865908,0.6550412354355004,104,58,0.40707964601769914,0.3156259583771482,0.5035273529945195,113,46,21,26,5,5,37,20,41,62
"sgc_coral-anthropic3710,sgc_coral-gemini25,sgc_coral-openai","3,2,1",0.5576923076923077,0.4569722043865908,0.6550412354355004,104,58,0.4690265486725664,0.3745099988696216,0.5652063110236246,113,53,27,33,11,5,31,20,35,55
"sgc_coral-gemini25,sgc_coral-openai,sgc_coral-openailong","2,1,3",0.5576923076923077,0.4569722043865908,0.6550412354355004,104,58,0.4247787610619469,0.33230431287413453,0.5212945922025517,113,48,25,27,9,4,33,21,37,61
"sgc_coral-gemini,sgc_coral-openai,sgc_coral-openailong","1,1,3",0.5576923076923077,0.4569722043865908,0.6550412354355004,104,58,0.5752212389380531,0.4787054077974483,0.6676956871258655,113,65,34,46,18,6,24,19,28,42
"sgc_coral-gemini,sgc_coral-openai,sgc_coral-openai10","1,1,1",0.5576923076923077,0.4569722043865908,0.6550412354355004,104,58,0.504424778761062,0.4087881883554824,0.599823792281213,113,57,38,41,22,9,20,16,24,47
"sgc_coral-gemini,sgc_coral-gemma,sgc_coral-openai45","1,1,1",0.5576923076923077,0.4569722043865908,0.6550412354355004,104,58,0.5929203539823009,0.4964726470054805,0.6843740416228519,113,67,36,54,20,12,22,13,26,34
"sgc_coral-anthropic3710,sgc_coral-gemini25,sgc_coral-gemma","3,2,1",0.5576923076923077,0.4569722043865908,0.6550412354355004,104,58,0.4690265486725664,0.3745099988696216,0.5652063110236246,113,53,26,36,10,8,32,17,36,52
"sgc_coral-gemini10,sgc_coral-gemini2510,sgc_coral-openai","4,2,1",0.5576923076923077,0.4569722043865908,0.6550412354355004,104,58,0.504424778761062,0.4087881883554824,0.599823792281213,113,57,28,40,12,8,30,17,34,48
"sgc_coral-anthropic37,sgc_coral-gemini,sgc_coral-gemma","7,1,1",0.5576923076923077,0.4569722043865908,0.6550412354355004,104,58,0.4778761061946903,0.38303706099768864,0.5739030980014965,113,54,28,36,12,7,30,18,34,52
"sgc_coral-gemini10,sgc_coral-gemini2510,sgc_coral-openai4510","4,2,1",0.5576923076923077,0.4569722043865908,0.6550412354355004,104,58,0.49557522123893805,0.40017620771878704,0.5912118116445175,113,56,30,38,14,7,28,18,32,50
"sgc_coral-anthropic10,sgc_coral-gemini,sgc_coral-openai45","4,1,1",0.5576923076923077,0.4569722043865908,0.6550412354355004,104,58,0.5398230088495575,0.44351884275715087,0.6339886086814048,113,61,29,46,13,10,29,15,33,42
"sgc_coral-anthropic37,sgc_coral-geminipro10,sgc_coral-openai10o1","7,1,1",0.5576923076923077,0.4569722043865908,0.6550412354355004,104,58,0.3805309734513274,0.2908336209275553,0.4766535155216661,113,43,26,24,10,6,32,19,36,64
"sgc_coral-anthropic10,sgc_coral-gemini10,sgc_coral-openai10","4,4,1",0.5576923076923077,0.4569722043865908,0.6550412354355004,104,58,0.3805309734513274,0.2908336209275553,0.4766535155216661,113,43,23,23,7,5,35,20,39,65
"sgc_coral-gemini25,sgc_coral-gemini2510,sgc_coral-openai4510","2,2,1",0.5576923076923077,0.4569722043865908,0.6550412354355004,104,58,0.48672566371681414,0.391592485688175,0.5825715848269355,113,55,29,37,13,7,29,18,33,51
"sgc_coral-anthropic37,sgc_coral-openai,sgc_coral-openai45","7,1,1",0.5576923076923077,0.4569722043865908,0.6550412354355004,104,58,0.5309734513274337,0.4347936889763754,0.6254900011303783,113,60,33,41,17,6,25,19,29,47
"sgc_coral-gemini25,sgc_coral-geminipro10,sgc_coral-gemma","2,1,1",0.5576923076923077,0.4569722043865908,0.6550412354355004,104,58,0.39823008849557523,0.30733148555269946,0.4945994395519369,113,45,27,28,11,8,31,17,35,60
"sgc_coral-anthropic37,sgc_coral-openai,sgc_coral-openai4510","7,1,1",0.5576923076923077,0.4569722043865908,0.6550412354355004,104,58,0.48672566371681414,0.391592485688175,0.5825715848269355,113,55,26,36,10,6,32,19,36,52
"sgc_coral-anthropic,sgc_coral-geminipro10,sgc_coral-openai10o1","1,1,1",0.5576923076923077,0.4569722043865908,0.6550412354355004,104,58,0.4778761061946903,0.38303706099768864,0.5739030980014965,113,54,36,42,20,13,22,12,26,46
"sgc_coral-anthropic37,sgc_coral-geminipro,sgc_coral-openaio1","7,1,2",0.5576923076923077,0.4569722043865908,0.6550412354355004,104,58,0.504424778761062,0.4087881883554824,0.599823792281213,113,57,23,36,7,4,35,21,39,52
"sgc_coral-anthropic10,sgc_coral-openai,sgc_coral-openai10o1","4,1,1",0.5576923076923077,0.4569722043865908,0.6550412354355004,104,58,0.46017699115044247,0.3660113913185952,0.5564811572428492,113,52,28,36,12,9,30,16,34,52
"sgc_coral-anthropic37,sgc_coral-geminipro,sgc_coral-gemma","7,1,1",0.5576923076923077,0.4569722043865908,0.6550412354355004,104,58,0.48672566371681414,0.391592485688175,0.5825715848269355,113,55,32,36,16,6,26,19,30,52
"sgc_coral-geminipro,sgc_coral-openai,sgc_coral-openai10","1,1,1",0.5576923076923077,0.4569722043865908,0.6550412354355004,104,58,0.5398230088495575,0.44351884275715087,0.6339886086814048,113,61,37,44,21,8,21,17,25,44
"sgc_coral-anthropic37,sgc_coral-gemini,sgc_coral-gemini10","7,1,4",0.5576923076923077,0.4569722043865908,0.6550412354355004,104,58,0.39823008849557523,0.30733148555269946,0.4945994395519369,113,45,21,25,5,5,37,20,41,63
"sgc_coral-gemini25,sgc_coral-geminipro10,sgc_coral-openai10o1","2,1,1",0.5576923076923077,0.4569722043865908,0.6550412354355004,104,58,0.34513274336283184,0.2582139731102288,0.44039054896588103,113,39,27,20,11,6,31,19,35,68
"sgc_coral-anthropic,sgc_coral-gemini10,sgc_coral-geminipro10","1,4,1",0.5576923076923077,0.4569722043865908,0.6550412354355004,104,58,0.415929203539823,0.3239503340286666,0.5124256476840243,113,47,26,29,10,7,32,18,36,59
"sgc_coral-gemini10,sgc_coral-geminipro10,sgc_coral-openai4510","4,1,1",0.5576923076923077,0.4569722043865908,0.6550412354355004,104,58,0.3893805309734513,0.29906724963482817,0.48564160577774956,113,44,24,28,8,9,34,16,38,60
"sgc_coral-gemini10,sgc_coral-geminipro10,sgc_coral-openai45","4,1,1",0.5576923076923077,0.4569722043865908,0.6550412354355004,104,58,0.4247787610619469,0.33230431287413453,0.5212945922025517,113,48,26,34,10,11,32,14,36,54
"sgc_coral-gemini2510,sgc_coral-openai10o1,sgc_coral-openaio1","2,1,2",0.5576923076923077,0.4569722043865908,0.6550412354355004,104,58,0.5752212389380531,0.4787054077974483,0.6676956871258655,113,65,32,50,16,10,26,15,30,38
"sgc_coral-gemini2510,sgc_coral-openai4510,sgc_coral-openaio1","2,1,2",0.5576923076923077,0.4569722043865908,0.6550412354355004,104,58,0.6548672566371682,0.559609451034119,0.7417860268897711,113,74,30,56,14,7,28,18,32,32
"sgc_coral-anthropic3710,sgc_coral-openai,sgc_coral-openaio1","3,1,2",0.5576923076923077,0.4569722043865908,0.6550412354355004,104,58,0.5752212389380531,0.4787054077974483,0.6676956871258655,113,65,29,44,13,4,29,21,33,44
"sgc_coral-geminipro,sgc_coral-gemma,sgc_coral-openai10","1,1,1",0.5576923076923077,0.4569722043865908,0.6550412354355004,104,58,0.5486725663716814,0.4522724568103532,0.642458642416372,113,62,38,48,22,11,20,14,24,40
"sgc_coral-geminipro10,sgc_coral-openai10,sgc_coral-openai4510","1,1,1",0.5576923076923077,0.4569722043865908,0.6550412354355004,104,58,0.5132743362831859,0.41742841517306456,0.608407514311825,113,58,34,43,18,10,24,15,28,45
"sgc_coral-geminipro10,sgc_coral-gemma,sgc_coral-openai","1,1,1",0.5576923076923077,0.4569722043865908,0.6550412354355004,104,58,0.5132743362831859,0.41742841517306456,0.608407514311825,113,58,35,46,19,13,23,12,27,42
"sgc_coral-gemini2510,sgc_coral-geminipro,sgc_coral-openai","2,1,1",0.5576923076923077,0.4569722043865908,0.6550412354355004,104,58,0.5398230088495575,0.44351884275715087,0.6339886086814048,113,61,40,47,24,11,18,14,22,41
"sgc_coral-openai,sgc_coral-openai10o1,sgc_coral-openailong","1,1,3",0.5576923076923077,0.4569722043865908,0.6550412354355004,104,58,0.4690265486725664,0.3745099988696216,0.5652063110236246,113,53,32,37,16,9,26,16,30,51
"sgc_coral-anthropic3710,sgc_coral-gemini10,sgc_coral-gemma","3,4,1",0.5576923076923077,0.4569722043865908,0.6550412354355004,104,58,0.4778761061946903,0.38303706099768864,0.5739030980014965,113,54,26,38,10,9,32,16,36,50
"sgc_coral-gemini,sgc_coral-geminipro10,sgc_coral-openai45","1,1,1",0.5576923076923077,0.4569722043865908,0.6550412354355004,104,58,0.5398230088495575,0.44351884275715087,0.6339886086814048,113,61,35,47,19,11,23,14,27,41
"sgc_coral-anthropic3710,sgc_coral-gemini10,sgc_coral-gemini25","3,4,2",0.5576923076923077,0.4569722043865908,0.6550412354355004,104,58,0.37168141592920356,0.28263100798002905,0.4676347962649451,113,42,21,22,5,5,37,20,41,66
"sgc_coral-anthropic,sgc_coral-anthropic37,sgc_coral-geminipro","1,7,1",0.5576923076923077,0.4569722043865908,0.6550412354355004,104,58,0.48672566371681414,0.391592485688175,0.5825715848269355,113,55,32,37,16,7,26,18,30,51
"sgc_coral-gemma,sgc_coral-openai10,sgc_coral-openai10o1","1,1,1",0.5576923076923077,0.4569722043865908,0.6550412354355004,104,58,0.45132743362831856,0.35754135758362804,0.5477275431896468,113,51,37,41,21,15,21,10,25,47
"sgc_coral-gemini,sgc_coral-geminipro,sgc_coral-geminipro10","1,1,1",0.5576923076923077,0.4569722043865908,0.6550412354355004,104,58,0.504424778761062,0.4087881883554824,0.599823792281213,113,57,36,44,20,12,22,13,26,44
"sgc_coral-anthropic37,sgc_coral-gemini10,sgc_coral-geminipro","7,4,1",0.5576923076923077,0.4569722043865908,0.6550412354355004,104,58,0.3805309734513274,0.2908336209275553,0.4766535155216661,113,43,21,21,5,3,37,22,41,67
"sgc_coral-gemini25,sgc_coral-openai45,sgc_coral-openai4510","2,1,1",0.5576923076923077,0.4569722043865908,0.6550412354355004,104,58,0.46017699115044247,0.3660113913185952,0.5564811572428492,113,52,27,37,11,10,31,15,35,51
"sgc_coral-gemini25,sgc_coral-gemma,sgc_coral-openaio1","2,1,2",0.5576923076923077,0.4569722043865908,0.6550412354355004,104,58,0.4778761061946903,0.38303706099768864,0.5739030980014965,113,54,22,32,6,3,36,22,40,56
"sgc_coral-gemini,sgc_coral-geminipro,sgc_coral-openai10","1,1,1",0.5576923076923077,0.4569722043865908,0.6550412354355004,104,58,0.5752212389380531,0.4787054077974483,0.6676956871258655,113,65,39,49,23,9,19,16,23,39
"sgc_coral-anthropic,sgc_coral-anthropic37,sgc_coral-openai10o1","1,7,1",0.5576923076923077,0.4569722043865908,0.6550412354355004,104,58,0.4247787610619469,0.33230431287413453,0.5212945922025517,113,48,30,31,14,8,28,17,32,57
"sgc_coral-gemini,sgc_coral-gemini10,sgc_coral-openai45","1,4,1",0.5576923076923077,0.4569722043865908,0.6550412354355004,104,58,0.48672566371681414,0.391592485688175,0.5825715848269355,113,55,28,40,12,10,30,15,34,48
"sgc_coral-gemini,sgc_coral-gemini10,sgc_coral-geminipro10","1,4,1",0.5576923076923077,0.4569722043865908,0.6550412354355004,104,58,0.40707964601769914,0.3156259583771482,0.5035273529945195,113,46,27,29,11,8,31,17,35,59
"sgc_coral-gemini,sgc_coral-geminipro10,sgc_coral-gemma","1,1,1",0.5576923076923077,0.4569722043865908,0.6550412354355004,104,58,0.49557522123893805,0.40017620771878704,0.5912118116445175,113,56,36,43,20,12,22,13,26,45
"sgc_coral-openai10,sgc_coral-openai10o1,sgc_coral-openai45","1,1,1",0.5576923076923077,0.4569722043865908,0.6550412354355004,104,58,0.504424778761062,0.4087881883554824,0.599823792281213,113,57,36,48,20,16,22,9,26,40
"sgc_coral-geminipro10,sgc_coral-openai10o1,sgc_coral-openai45","1,1,1",0.5576923076923077,0.4569722043865908,0.6550412354355004,104,58,0.49557522123893805,0.40017620771878704,0.5912118116445175,113,56,34,46,18,15,24,10,28,42
"sgc_coral-geminipro,sgc_coral-openai10,sgc_coral-openai10o1","1,1,1",0.5480769230769231,0.4474460291380616,0.6458988384607541,104,57,0.504424778761062,0.4087881883554824,0.599823792281213,113,57,39,42,24,10,18,15,23,46
"sgc_coral-anthropic37,sgc_coral-gemini10,sgc_coral-gemma","7,4,1",0.5480769230769231,0.4474460291380616,0.6458988384607541,104,57,0.4247787610619469,0.33230431287413453,0.5212945922025517,113,48,20,27,5,4,37,21,42,61
"sgc_coral-anthropic10,sgc_coral-openai10o1,sgc_coral-openaio1","4,1,2",0.5480769230769231,0.4474460291380616,0.6458988384607541,104,57,0.5132743362831859,0.41742841517306456,0.608407514311825,113,58,22,38,7,5,35,20,40,50
"sgc_coral-geminipro,sgc_coral-gemma,sgc_coral-openailong","1,1,3",0.5480769230769231,0.4474460291380616,0.6458988384607541,104,57,0.5486725663716814,0.4522724568103532,0.642458642416372,113,62,35,45,20,8,22,17,27,43
"sgc_coral-anthropic,sgc_coral-geminipro,sgc_coral-openai10o1","1,1,1",0.5480769230769231,0.4474460291380616,0.6458988384607541,104,57,0.4778761061946903,0.38303706099768864,0.5739030980014965,113,54,36,43,21,14,21,11,26,45
"sgc_coral-anthropic,sgc_coral-anthropic10,sgc_coral-openai45","1,4,1",0.5480769230769231,0.4474460291380616,0.6458988384607541,104,57,0.5221238938053098,0.4260969019985035,0.6169629390023114,113,59,31,45,16,11,26,14,31,43
"sgc_coral-anthropic,sgc_coral-openai4510,sgc_coral-openailong","1,1,3",0.5480769230769231,0.4474460291380616,0.6458988384607541,104,57,0.5663716814159292,0.4698655764900294,0.6593123718320077,113,64,35,49,20,10,22,15,27,39
"sgc_coral-anthropic,sgc_coral-anthropic10,sgc_coral-gemini","1,4,1",0.5480769230769231,0.4474460291380616,0.6458988384607541,104,57,0.49557522123893805,0.40017620771878704,0.5912118116445175,113,56,32,40,17,9,25,16,30,48
"sgc_coral-anthropic10,sgc_coral-gemini25,sgc_coral-openaio1","4,2,2",0.5480769230769231,0.4474460291380616,0.6458988384607541,104,57,0.3805309734513274,0.2908336209275553,0.4766535155216661,113,43,18,21,3,3,39,22,44,67
"sgc_coral-gemini10,sgc_coral-geminipro10,sgc_coral-openaio1","4,1,2",0.5480769230769231,0.4474460291380616,0.6458988384607541,104,57,0.4247787610619469,0.33230431287413453,0.5212945922025517,113,48,18,27,3,4,39,21,44,61
"sgc_coral-gemini25,sgc_coral-geminipro10,sgc_coral-openai4510","2,1,1",0.5480769230769231,0.4474460291380616,0.6458988384607541,104,57,0.3893805309734513,0.29906724963482817,0.48564160577774956,113,44,24,27,9,8,33,17,38,61
"sgc_coral-gemini10,sgc_coral-gemma,sgc_coral-openai10o1","4,1,1",0.5480769230769231,0.4474460291380616,0.6458988384607541,104,57,0.46017699115044247,0.3660113913185952,0.5564811572428492,113,52,25,37,10,10,32,15,37,51
"sgc_coral-anthropic,sgc_coral-gemini25,sgc_coral-gemma","1,2,1",0.5480769230769231,0.4474460291380616,0.6458988384607541,104,57,0.49557522123893805,0.40017620771878704,0.5912118116445175,113,56,28,39,13,8,29,17,34,49
"sgc_coral-gemini25,sgc_coral-geminipro10,sgc_coral-openai45","2,1,1",0.5480769230769231,0.4474460291380616,0.6458988384607541,104,57,0.4247787610619469,0.33230431287413453,0.5212945922025517,113,48,26,33,11,10,31,15,36,55
"sgc_coral-gemini,sgc_coral-gemini25,sgc_coral-geminipro","1,2,1",0.5480769230769231,0.4474460291380616,0.6458988384607541,104,57,0.4690265486725664,0.3745099988696216,0.5652063110236246,113,53,29,33,14,5,28,20,33,55
"sgc_coral-gemini10,sgc_coral-gemma,sgc_coral-openaio1","4,1,2",0.5480769230769231,0.4474460291380616,0.6458988384607541,104,57,0.4778761061946903,0.38303706099768864,0.5739030980014965,113,54,21,33,6,4,36,21,41,55
"sgc_coral-gemini10,sgc_coral-openai,sgc_coral-openailong","4,1,3",0.5480769230769231,0.4474460291380616,0.6458988384607541,104,57,0.3893805309734513,0.29906724963482817,0.48564160577774956,113,44,22,26,7,7,35,18,40,62
"sgc_coral-anthropic,sgc_coral-anthropic10,sgc_coral-gemini10","1,4,4",0.5480769230769231,0.4474460291380616,0.6458988384607541,104,57,0.4247787610619469,0.33230431287413453,0.5212945922025517,113,48,19,29,4,6,38,19,43,59
"sgc_coral-anthropic10,sgc_coral-anthropic37,sgc_coral-gemini10","4,7,4",0.5480769230769231,0.4474460291380616,0.6458988384607541,104,57,0.3805309734513274,0.2908336209275553,0.4766535155216661,113,43,20,22,5,4,37,21,42,66
"sgc_coral-anthropic3710,sgc_coral-geminipro,sgc_coral-openai","3,1,1",0.5480769230769231,0.4474460291380616,0.6458988384607541,104,57,0.5221238938053098,0.4260969019985035,0.6169629390023114,113,59,33,43,18,9,24,16,29,45
"sgc_coral-anthropic,sgc_coral-geminipro,sgc_coral-openaio1","1,1,2",0.5480769230769231,0.4474460291380616,0.6458988384607541,104,57,0.5663716814159292,0.4698655764900294,0.6593123718320077,113,64,32,45,17,6,25,19,30,43
"sgc_coral-anthropic,sgc_coral-gemini25,sgc_coral-geminipro","1,2,1",0.5480769230769231,0.4474460291380616,0.6458988384607541,104,57,0.4336283185840708,0.3406876281679922,0.5301344235099705,113,49,30,31,15,7,27,18,32,57
"sgc_coral-anthropic10,sgc_coral-anthropic37,sgc_coral-gemini25","4,7,2",0.5480769230769231,0.4474460291380616,0.6458988384607541,104,57,0.35398230088495575,0.26632066883004546,0.44950378631102667,113,40,20,17,5,2,37,23,42,71
"sgc_coral-anthropic,sgc_coral-anthropic37,sgc_coral-gemini","1,7,1",0.5480769230769231,0.4474460291380616,0.6458988384607541,104,57,0.5221238938053098,0.4260969019985035,0.6169629390023114,113,59,31,39,16,5,26,20,31,49
"sgc_coral-anthropic,sgc_coral-geminipro10,sgc_coral-openai4510","1,1,1",0.5480769230769231,0.4474460291380616,0.6458988384607541,104,57,0.4778761061946903,0.38303706099768864,0.5739030980014965,113,54,34,41,19,12,23,13,28,47
"sgc_coral-anthropic,sgc_coral-gemma,sgc_coral-openai4510","1,1,1",0.5480769230769231,0.4474460291380616,0.6458988384607541,104,57,0.5221238938053098,0.4260969019985035,0.6169629390023114,113,59,35,48,20,14,22,11,27,40
"sgc_coral-anthropic,sgc_coral-anthropic37,sgc_coral-openaio1","1,7,2",0.5480769230769231,0.4474460291380616,0.6458988384607541,104,57,0.4778761061946903,0.38303706099768864,0.5739030980014965,113,54,23,32,8,3,34,22,39,56
"sgc_coral-gemma,sgc_coral-openai10,sgc_coral-openai4510","1,1,1",0.5480769230769231,0.4474460291380616,0.6458988384607541,104,57,0.5663716814159292,0.4698655764900294,0.6593123718320077,113,64,34,50,19,11,23,14,28,38
"sgc_coral-anthropic,sgc_coral-openai10,sgc_coral-openai10o1","1,1,1",0.5480769230769231,0.4474460291380616,0.6458988384607541,104,57,0.4778761061946903,0.38303706099768864,0.5739030980014965,113,54,37,42,22,13,20,12,25,46
"sgc_coral-anthropic10,sgc_coral-anthropic37,sgc_coral-openai4510","4,7,1",0.5480769230769231,0.4474460291380616,0.6458988384607541,104,57,0.40707964601769914,0.3156259583771482,0.5035273529945195,113,46,20,26,5,5,37,20,42,62
"sgc_coral-anthropic10,sgc_coral-geminipro,sgc_coral-openaio1","4,1,2",0.5480769230769231,0.4474460291380616,0.6458988384607541,104,57,0.4690265486725664,0.3745099988696216,0.5652063110236246,113,53,22,35,7,7,35,18,40,53
"sgc_coral-geminipro10,sgc_coral-openai,sgc_coral-openaio1","1,1,2",0.5480769230769231,0.4474460291380616,0.6458988384607541,104,57,0.5132743362831859,0.41742841517306456,0.608407514311825,113,58,26,41,11,8,31,17,36,47
"sgc_coral-anthropic,sgc_coral-anthropic37,sgc_coral-openai4510","1,7,1",0.5480769230769231,0.4474460291380616,0.6458988384607541,104,57,0.5309734513274337,0.4347936889763754,0.6254900011303783,113,60,29,40,14,5,28,20,33,48
"sgc_coral-gemini25,sgc_coral-gemma,sgc_coral-openai10o1","2,1,1",0.5480769230769231,0.4474460291380616,0.6458988384607541,104,57,0.46017699115044247,0.3660113913185952,0.5564811572428492,113,52,26,36,11,9,31,16,36,52
"sgc_coral-anthropic37,sgc_coral-gemini,sgc_coral-openai4510","7,1,1",0.5480769230769231,0.4474460291380616,0.6458988384607541,104,57,0.5132743362831859,0.41742841517306456,0.608407514311825,113,58,25,39,10,6,32,19,37,49
"sgc_coral-anthropic,sgc_coral-anthropic37,sgc_coral-openai45","1,7,1",0.5480769230769231,0.4474460291380616,0.6458988384607541,104,57,0.5398230088495575,0.44351884275715087,0.6339886086814048,113,61,31,44,16,8,26,17,31,44
"sgc_coral-geminipro10,sgc_coral-openai4510,sgc_coral-openaio1","1,1,2",0.5480769230769231,0.4474460291380616,0.6458988384607541,104,57,0.4690265486725664,0.3745099988696216,0.5652063110236246,113,53,26,37,11,9,31,16,36,51
"sgc_coral-gemini,sgc_coral-openai10o1,sgc_coral-openai4510","1,1,1",0.5480769230769231,0.4474460291380616,0.6458988384607541,104,57,0.5309734513274337,0.4347936889763754,0.6254900011303783,113,60,31,45,16,10,26,15,31,43
"sgc_coral-anthropic3710,sgc_coral-gemma,sgc_coral-openai4510","3,1,1",0.5480769230769231,0.4474460291380616,0.6458988384607541,104,57,0.5309734513274337,0.4347936889763754,0.6254900011303783,113,60,30,47,15,12,27,13,32,41
"sgc_coral-anthropic3710,sgc_coral-gemini,sgc_coral-geminipro","3,1,1",0.5480769230769231,0.4474460291380616,0.6458988384607541,104,57,0.5309734513274337,0.4347936889763754,0.6254900011303783,113,60,36,45,21,10,21,15,26,43
"sgc_coral-anthropic10,sgc_coral-geminipro,sgc_coral-openai4510","4,1,1",0.5480769230769231,0.4474460291380616,0.6458988384607541,104,57,0.5132743362831859,0.41742841517306456,0.608407514311825,113,58,25,43,10,10,32,15,37,45
"sgc_coral-gemma,sgc_coral-openai,sgc_coral-openai10","1,1,1",0.5480769230769231,0.4474460291380616,0.6458988384607541,104,57,0.5132743362831859,0.41742841517306456,0.608407514311825,113,58,36,43,21,10,21,15,26,45
"sgc_coral-openai45,sgc_coral-openai4510,sgc_coral-openaio1","1,1,2",0.5480769230769231,0.4474460291380616,0.6458988384607541,104,57,0.5752212389380531,0.4787054077974483,0.6676956871258655,113,65,27,49,12,9,30,16,35,39
"sgc_coral-geminipro,sgc_coral-geminipro10,sgc_coral-openai45","1,1,1",0.5480769230769231,0.4474460291380616,0.6458988384607541,104,57,0.504424778761062,0.4087881883554824,0.599823792281213,113,57,37,45,22,13,20,12,25,43
"sgc_coral-anthropic,sgc_coral-gemini,sgc_coral-gemini25","1,1,2",0.5480769230769231,0.4474460291380616,0.6458988384607541,104,57,0.4424778761061947,0.3491000446929689,0.5389453481338661,113,50,31,31,16,6,26,19,31,57
"sgc_coral-anthropic10,sgc_coral-gemini25,sgc_coral-openailong","4,2,3",0.5480769230769231,0.4474460291380616,0.6458988384607541,104,57,0.4247787610619469,0.33230431287413453,0.5212945922025517,113,48,24,28,9,5,33,20,38,60
"sgc_coral-gemini25,sgc_coral-geminipro10,sgc_coral-openaio1","2,1,2",0.5480769230769231,0.4474460291380616,0.6458988384607541,104,57,0.40707964601769914,0.3156259583771482,0.5035273529945195,113,46,18,26,3,5,39,20,44,62
"sgc_coral-geminipro,sgc_coral-openai10o1,sgc_coral-openailong","1,1,3",0.5480769230769231,0.4474460291380616,0.6458988384607541,104,57,0.5221238938053098,0.4260969019985035,0.6169629390023114,113,59,34,43,19,9,23,16,28,45
"sgc_coral-gemini25,sgc_coral-openai,sgc_coral-openai10","2,1,1",0.5384615384615384,0.4379549402240126,0.6367211715616949,104,56,0.4424778761061947,0.3491000446929689,0.5389453481338661,113,50,29,30,15,5,27,20,33,58
"sgc_coral-anthropic10,sgc_coral-anthropic37,sgc_coral-openaio1","4,7,2",0.5384615384615384,0.4379549402240126,0.6367211715616949,104,56,0.4424778761061947,0.3491000446929689,0.5389453481338661,113,50,18,28,4,3,38,22,44,60
"sgc_coral-geminipro10,sgc_coral-gemma,sgc_coral-openai4510","1,1,1",0.5384615384615384,0.4379549402240126,0.6367211715616949,104,56,0.45132743362831856,0.35754135758362804,0.5477275431896468,113,51,29,41,15,15,27,10,33,47
"sgc_coral-anthropic10,sgc_coral-gemini25,sgc_coral-gemma","4,2,1",0.5384615384615384,0.4379549402240126,0.6367211715616949,104,56,0.3893805309734513,0.29906724963482817,0.48564160577774956,113,44,20,25,6,6,36,19,42,63
"sgc_coral-anthropic,sgc_coral-gemini25,sgc_coral-openai45","1,2,1",0.5384615384615384,0.4379549402240126,0.6367211715616949,104,56,0.4336283185840708,0.3406876281679922,0.5301344235099705,113,49,29,33,15,9,27,16,33,55
"sgc_coral-anthropic37,sgc_coral-openai,sgc_coral-openaio1","7,1,2",0.5384615384615384,0.4379549402240126,0.6367211715616949,104,56,0.5309734513274337,0.4347936889763754,0.6254900011303783,113,60,19,35,5,0,37,25,43,53
"sgc_coral-gemini,sgc_coral-gemini2510,sgc_coral-openai","1,2,1",0.5384615384615384,0.4379549402240126,0.6367211715616949,104,56,0.6106194690265486,0.5143583942222505,0.7009327503651719,113,69,38,52,24,8,18,17,24,36
"sgc_coral-geminipro10,sgc_coral-openai45,sgc_coral-openai4510","1,1,1",0.5384615384615384,0.4379549402240126,0.6367211715616949,104,56,0.5309734513274337,0.4347936889763754,0.6254900011303783,113,60,31,49,17,14,25,11,31,39
"sgc_coral-anthropic10,sgc_coral-openai,sgc_coral-openai4510","4,1,1",0.5384615384615384,0.4379549402240126,0.6367211715616949,104,56,0.48672566371681414,0.391592485688175,0.5825715848269355,113,55,24,38,10,8,32,17,38,50
"sgc_coral-anthropic10,sgc_coral-gemini,sgc_coral-geminipro","4,1,1",0.5384615384615384,0.4379549402240126,0.6367211715616949,104,56,0.4778761061946903,0.38303706099768864,0.5739030980014965,113,54,30,37,16,8,26,17,32,51
"sgc_coral-anthropic10,sgc_coral-openai10o1,sgc_coral-openai45","4,1,1",0.5384615384615384,0.4379549402240126,0.6367211715616949,104,56,0.48672566371681414,0.391592485688175,0.5825715848269355,113,55,27,38,13,8,29,17,35,50
"sgc_coral-geminipro10,sgc_coral-openai,sgc_coral-openai10","1,1,1",0.5384615384615384,0.4379549402240126,0.6367211715616949,104,56,0.504424778761062,0.4087881883554824,0.599823792281213,113,57,36,41,22,9,20,16,26,47
"sgc_coral-anthropic10,sgc_coral-openai4510,sgc_coral-openaio1","4,1,2",0.5384615384615384,0.4379549402240126,0.6367211715616949,104,56,0.5132743362831859,0.41742841517306456,0.608407514311825,113,58,21,39,7,6,35,19,41,49
"sgc_coral-anthropic,sgc_coral-openai10o1,sgc_coral-openaio1","1,1,2",0.5384615384615384,0.4379549402240126,0.6367211715616949,104,56,0.5398230088495575,0.44351884275715087,0.6339886086814048,113,61,30,46,16,10,26,15,32,42
"sgc_coral-geminipro,sgc_coral-openai,sgc_coral-openailong","1,1,3",0.5384615384615384,0.4379549402240126,0.6367211715616949,104,56,0.504424778761062,0.4087881883554824,0.599823792281213,113,57,34,41,20,9,22,16,28,47
"sgc_coral-anthropic37,sgc_coral-gemini25,sgc_coral-openaio1","7,2,2",0.5384615384615384,0.4379549402240126,0.6367211715616949,104,56,0.3805309734513274,0.2908336209275553,0.4766535155216661,113,43,18,20,4,2,38,23,44,68
"sgc_coral-gemini,sgc_coral-gemini25,sgc_coral-openaio1","1,2,2",0.5384615384615384,0.4379549402240126,0.6367211715616949,104,56,0.45132743362831856,0.35754135758362804,0.5477275431896468,113,51,21,29,7,3,35,22,41,59
"sgc_coral-anthropic,sgc_coral-gemma,sgc_coral-openai45","1,1,1",0.5384615384615384,0.4379549402240126,0.6367211715616949,104,56,0.5663716814159292,0.4698655764900294,0.6593123718320077,113,64,37,53,23,14,19,11,25,35
"sgc_coral-anthropic10,sgc_coral-gemini25,sgc_coral-openai4510","4,2,1",0.5384615384615384,0.4379549402240126,0.6367211715616949,104,56,0.3893805309734513,0.29906724963482817,0.48564160577774956,113,44,19,24,5,5,37,20,43,64
"sgc_coral-anthropic37,sgc_coral-gemini10,sgc_coral-openai45","7,4,1",0.5384615384615384,0.4379549402240126,0.6367211715616949,104,56,0.46017699115044247,0.3660113913185952,0.5564811572428492,113,52,19,31,5,4,37,21,43,57
"sgc_coral-gemini,sgc_coral-gemini2510,sgc_coral-geminipro","1,2,1",0.5384615384615384,0.4379549402240126,0.6367211715616949,104,56,0.5929203539823009,0.4964726470054805,0.6843740416228519,113,67,38,53,24,11,18,14,24,35
"sgc_coral-gemini25,sgc_coral-geminipro,sgc_coral-openai4510","2,1,1",0.5384615384615384,0.4379549402240126,0.6367211715616949,104,56,0.39823008849557523,0.30733148555269946,0.4945994395519369,113,45,24,29,10,9,32,16,38,59
"sgc_coral-gemini10,sgc_coral-openai45,sgc_coral-openai4510","4,1,1",0.5384615384615384,0.4379549402240126,0.6367211715616949,104,56,0.4778761061946903,0.38303706099768864,0.5739030980014965,113,54,25,39,11,10,31,15,37,49
"sgc_coral-gemini2510,sgc_coral-gemma,sgc_coral-openai","2,1,1",0.5384615384615384,0.4379549402240126,0.6367211715616949,104,56,0.6106194690265486,0.5143583942222505,0.7009327503651719,113,69,38,57,24,13,18,12,24,31
"sgc_coral-anthropic37,sgc_coral-gemini,sgc_coral-geminipro","7,1,1",0.5384615384615384,0.4379549402240126,0.6367211715616949,104,56,0.49557522123893805,0.40017620771878704,0.5912118116445175,113,56,29,35,15,4,27,21,33,53
"sgc_coral-anthropic,sgc_coral-gemma,sgc_coral-openai10","1,1,1",0.5384615384615384,0.4379549402240126,0.6367211715616949,104,56,0.5221238938053098,0.4260969019985035,0.6169629390023114,113,59,38,45,24,11,18,14,24,43
"sgc_coral-gemini10,sgc_coral-gemini25,sgc_coral-gemma","4,2,1",0.5384615384615384,0.4379549402240126,0.6367211715616949,104,56,0.36283185840707965,0.2744598598768483,0.4585850370789202,113,41,21,20,7,4,35,21,41,68
"sgc_coral-geminipro,sgc_coral-openai4510,sgc_coral-openaio1","1,1,2",0.5384615384615384,0.4379549402240126,0.6367211715616949,104,56,0.5398230088495575,0.44351884275715087,0.6339886086814048,113,61,26,45,12,9,30,16,36,43
"sgc_coral-gemma,sgc_coral-openai4510,sgc_coral-openaio1","1,1,2",0.5384615384615384,0.4379549402240126,0.6367211715616949,104,56,0.5398230088495575,0.44351884275715087,0.6339886086814048,113,61,24,44,10,8,32,17,38,44
"sgc_coral-anthropic37,sgc_coral-gemini10,sgc_coral-openaio1","7,4,2",0.5384615384615384,0.4379549402240126,0.6367211715616949,104,56,0.3893805309734513,0.29906724963482817,0.48564160577774956,113,44,18,22,4,3,38,22,44,66
"sgc_coral-anthropic10,sgc_coral-gemini25,sgc_coral-openai10o1","4,2,1",0.5384615384615384,0.4379549402240126,0.6367211715616949,104,56,0.37168141592920356,0.28263100798002905,0.4676347962649451,113,42,20,22,6,5,36,20,42,66
"sgc_coral-anthropic10,sgc_coral-gemini,sgc_coral-gemini25","4,1,2",0.5384615384615384,0.4379549402240126,0.6367211715616949,104,56,0.37168141592920356,0.28263100798002905,0.4676347962649451,113,42,21,22,7,5,35,20,41,66
"sgc_coral-anthropic10,sgc_coral-gemini25,sgc_coral-openai","4,2,1",0.5384615384615384,0.4379549402240126,0.6367211715616949,104,56,0.3893805309734513,0.29906724963482817,0.48564160577774956,113,44,19,23,5,4,37,21,43,65
"sgc_coral-gemini,sgc_coral-gemini25,sgc_coral-openai10o1","1,2,1",0.5384615384615384,0.4379549402240126,0.6367211715616949,104,56,0.37168141592920356,0.28263100798002905,0.4676347962649451,113,42,27,25,13,8,29,17,35,63
"sgc_coral-anthropic37,sgc_coral-gemini,sgc_coral-gemini25","7,1,2",0.5384615384615384,0.4379549402240126,0.6367211715616949,104,56,0.3893805309734513,0.29906724963482817,0.48564160577774956,113,44,19,22,5,3,37,22,43,66
"sgc_coral-anthropic,sgc_coral-gemini,sgc_coral-gemma","1,1,1",0.5384615384615384,0.4379549402240126,0.6367211715616949,104,56,0.5575221238938053,0.4610546518661339,0.6508999553070312,113,63,37,50,23,12,19,13,25,38
"sgc_coral-gemini,sgc_coral-openai45,sgc_coral-openai4510","1,1,1",0.5384615384615384,0.4379549402240126,0.6367211715616949,104,56,0.5752212389380531,0.4787054077974483,0.6676956871258655,113,65,34,52,20,12,22,13,28,36
"sgc_coral-gemini10,sgc_coral-gemini25,sgc_coral-openai10","4,2,1",0.5384615384615384,0.4379549402240126,0.6367211715616949,104,56,0.336283185840708,0.2501403603610025,0.4312447837432745,113,38,18,16,4,3,38,22,44,72
"sgc_coral-anthropic,sgc_coral-openai10o1,sgc_coral-openai4510","1,1,1",0.5384615384615384,0.4379549402240126,0.6367211715616949,104,56,0.5221238938053098,0.4260969019985035,0.6169629390023114,113,59,36,46,22,12,20,13,26,42
"sgc_coral-gemini,sgc_coral-gemini10,sgc_coral-openaio1","1,4,2",0.5384615384615384,0.4379549402240126,0.6367211715616949,104,56,0.45132743362831856,0.35754135758362804,0.5477275431896468,113,51,19,30,5,4,37,21,43,58
"sgc_coral-anthropic,sgc_coral-anthropic10,sgc_coral-openai","1,4,1",0.5384615384615384,0.4379549402240126,0.6367211715616949,104,56,0.504424778761062,0.4087881883554824,0.599823792281213,113,57,28,39,14,7,28,18,34,49
"sgc_coral-anthropic10,sgc_coral-gemini,sgc_coral-openai10o1","4,1,1",0.5384615384615384,0.4379549402240126,0.6367211715616949,104,56,0.46017699115044247,0.3660113913185952,0.5564811572428492,113,52,28,35,14,8,28,17,34,53
"sgc_coral-anthropic3710,sgc_coral-gemma,sgc_coral-openai","3,1,1",0.5384615384615384,0.4379549402240126,0.6367211715616949,104,56,0.5486725663716814,0.4522724568103532,0.642458642416372,113,62,33,49,19,12,23,13,29,39
"sgc_coral-geminipro10,sgc_coral-gemma,sgc_coral-openai45","1,1,1",0.5384615384615384,0.4379549402240126,0.6367211715616949,104,56,0.5486725663716814,0.4522724568103532,0.642458642416372,113,62,33,52,19,15,23,10,29,36
"sgc_coral-anthropic37,sgc_coral-gemini10,sgc_coral-openai10o1","7,4,1",0.5384615384615384,0.4379549402240126,0.6367211715616949,104,56,0.3893805309734513,0.29906724963482817,0.48564160577774956,113,44,19,24,5,5,37,20,43,64
"sgc_coral-anthropic3710,sgc_coral-gemini10,sgc_coral-openai","3,4,1",0.5384615384615384,0.4379549402240126,0.6367211715616949,104,56,0.4690265486725664,0.3745099988696216,0.5652063110236246,113,53,25,33,11,5,31,20,37,55
"sgc_coral-gemini25,sgc_coral-openai4510,sgc_coral-openaio1","2,1,2",0.5288461538461539,0.4284987821872685,0.627508428100276,104,55,0.4690265486725664,0.3745099988696216,0.5652063110236246,113,53,20,30,7,2,35,23,42,58
"sgc_coral-anthropic,sgc_coral-gemini2510,sgc_coral-openai10o1","1,2,1",0.5288461538461539,0.4284987821872685,0.627508428100276,104,55,0.5221238938053098,0.4260969019985035,0.6169629390023114,113,59,35,49,22,15,20,10,27,39
"sgc_coral-anthropic,sgc_coral-geminipro,sgc_coral-geminipro10","1,1,1",0.5288461538461539,0.4284987821872685,0.627508428100276,104,55,0.49557522123893805,0.40017620771878704,0.5912118116445175,113,56,35,40,22,9,20,16,27,48
"sgc_coral-geminipro,sgc_coral-openai10,sgc_coral-openaio1","1,1,2",0.5288461538461539,0.4284987821872685,0.627508428100276,104,55,0.5221238938053098,0.4260969019985035,0.6169629390023114,113,59,30,41,17,7,25,18,32,47
"sgc_coral-anthropic37,sgc_coral-gemini10,sgc_coral-openai","7,4,1",0.5288461538461539,0.4284987821872685,0.627508428100276,104,55,0.40707964601769914,0.3156259583771482,0.5035273529945195,113,46,18,23,5,2,37,23,44,65
"sgc_coral-anthropic37,sgc_coral-geminipro,sgc_coral-openai45","7,1,1",0.5288461538461539,0.4284987821872685,0.627508428100276,104,55,0.504424778761062,0.4087881883554824,0.599823792281213,113,57,31,37,18,5,24,20,31,51
"sgc_coral-anthropic,sgc_coral-anthropic10,sgc_coral-openai4510","1,4,1",0.5288461538461539,0.4284987821872685,0.627508428100276,104,55,0.504424778761062,0.4087881883554824,0.599823792281213,113,57,28,42,15,10,27,15,34,46
"sgc_coral-anthropic37,sgc_coral-gemini10,sgc_coral-openai4510","7,4,1",0.5288461538461539,0.4284987821872685,0.627508428100276,104,55,0.3805309734513274,0.2908336209275553,0.4766535155216661,113,43,19,23,6,5,36,20,43,65
"sgc_coral-openai,sgc_coral-openai10,sgc_coral-openai4510","1,1,1",0.5288461538461539,0.4284987821872685,0.627508428100276,104,55,0.48672566371681414,0.391592485688175,0.5825715848269355,113,55,32,40,19,10,23,15,30,48
"sgc_coral-gemma,sgc_coral-openai10o1,sgc_coral-openaio1","1,1,2",0.5288461538461539,0.4284987821872685,0.627508428100276,104,55,0.5575221238938053,0.4610546518661339,0.6508999553070312,113,63,26,47,13,9,29,16,36,41
"sgc_coral-anthropic37,sgc_coral-gemini25,sgc_coral-geminipro","7,2,1",0.5288461538461539,0.4284987821872685,0.627508428100276,104,55,0.39823008849557523,0.30733148555269946,0.4945994395519369,113,45,19,22,6,2,36,23,43,66
"sgc_coral-anthropic37,sgc_coral-gemini25,sgc_coral-openai10o1","7,2,1",0.5288461538461539,0.4284987821872685,0.627508428100276,104,55,0.36283185840707965,0.2744598598768483,0.4585850370789202,113,41,19,20,6,4,36,21,43,68
"sgc_coral-geminipro10,sgc_coral-openai10o1,sgc_coral-openaio1","1,1,2",0.5288461538461539,0.4284987821872685,0.627508428100276,104,55,0.4424778761061947,0.3491000446929689,0.5389453481338661,113,50,25,33,12,8,30,17,37,55
"sgc_coral-geminipro10,sgc_coral-openai,sgc_coral-openai4510","1,1,1",0.5288461538461539,0.4284987821872685,0.627508428100276,104,55,0.49557522123893805,0.40017620771878704,0.5912118116445175,113,56,30,42,17,11,25,14,32,46
"sgc_coral-anthropic37,sgc_coral-gemini,sgc_coral-openai","7,1,1",0.5288461538461539,0.4284987821872685,0.627508428100276,104,55,0.5663716814159292,0.4698655764900294,0.6593123718320077,113,64,28,40,15,1,27,24,34,48
"sgc_coral-geminipro,sgc_coral-openai10o1,sgc_coral-openai4510","1,1,1",0.5288461538461539,0.4284987821872685,0.627508428100276,104,55,0.4424778761061947,0.3491000446929689,0.5389453481338661,113,50,33,38,20,13,22,12,29,50
"sgc_coral-geminipro,sgc_coral-openai10,sgc_coral-openai4510","1,1,1",0.5288461538461539,0.4284987821872685,0.627508428100276,104,55,0.5132743362831859,0.41742841517306456,0.608407514311825,113,58,34,43,21,10,21,15,28,45
"sgc_coral-anthropic,sgc_coral-gemini,sgc_coral-openai4510","1,1,1",0.5288461538461539,0.4284987821872685,0.627508428100276,104,55,0.5221238938053098,0.4260969019985035,0.6169629390023114,113,59,35,46,22,12,20,13,27,42
"sgc_coral-anthropic,sgc_coral-gemini10,sgc_coral-geminipro","1,4,1",0.5288461538461539,0.4284987821872685,0.627508428100276,104,55,0.4424778761061947,0.3491000446929689,0.5389453481338661,113,50,29,33,16,8,26,17,33,55
"sgc_coral-anthropic,sgc_coral-gemini10,sgc_coral-gemma","1,4,1",0.5288461538461539,0.4284987821872685,0.627508428100276,104,55,0.4778761061946903,0.38303706099768864,0.5739030980014965,113,54,26,39,13,10,29,15,36,49
"sgc_coral-anthropic37,sgc_coral-geminipro,sgc_coral-openai","7,1,1",0.5288461538461539,0.4284987821872685,0.627508428100276,104,55,0.504424778761062,0.4087881883554824,0.599823792281213,113,57,27,37,14,5,28,20,35,51
"sgc_coral-anthropic,sgc_coral-geminipro,sgc_coral-openai10","1,1,1",0.5288461538461539,0.4284987821872685,0.627508428100276,104,55,0.5221238938053098,0.4260969019985035,0.6169629390023114,113,59,38,45,25,11,17,14,24,43
"sgc_coral-anthropic10,sgc_coral-gemini25,sgc_coral-geminipro","4,2,1",0.5288461538461539,0.4284987821872685,0.627508428100276,104,55,0.3805309734513274,0.2908336209275553,0.4766535155216661,113,43,20,24,7,6,35,19,42,64
"sgc_coral-gemini25,sgc_coral-geminipro,sgc_coral-gemma","2,1,1",0.5288461538461539,0.4284987821872685,0.627508428100276,104,55,0.415929203539823,0.3239503340286666,0.5124256476840243,113,47,28,28,15,6,27,19,34,60
"sgc_coral-gemini10,sgc_coral-gemini25,sgc_coral-openaio1","4,2,2",0.5288461538461539,0.4284987821872685,0.627508428100276,104,55,0.34513274336283184,0.2582139731102288,0.44039054896588103,113,39,16,17,3,3,39,22,46,71
"sgc_coral-anthropic10,sgc_coral-openai,sgc_coral-openai10","4,1,1",0.5288461538461539,0.4284987821872685,0.627508428100276,104,55,0.5132743362831859,0.41742841517306456,0.608407514311825,113,58,29,40,16,7,26,18,33,48
"sgc_coral-gemini,sgc_coral-geminipro10,sgc_coral-openai","1,1,1",0.5288461538461539,0.4284987821872685,0.627508428100276,104,55,0.4690265486725664,0.3745099988696216,0.5652063110236246,113,53,33,39,20,11,22,14,29,49
"sgc_coral-gemini10,sgc_coral-openai10,sgc_coral-openaio1","4,1,2",0.5288461538461539,0.4284987821872685,0.627508428100276,104,55,0.46017699115044247,0.3660113913185952,0.5564811572428492,113,52,19,31,6,4,36,21,43,57
"sgc_coral-gemini,sgc_coral-geminipro,sgc_coral-openai45","1,1,1",0.5288461538461539,0.4284987821872685,0.627508428100276,104,55,0.5575221238938053,0.4610546518661339,0.6508999553070312,113,63,36,50,23,12,19,13,26,38
"sgc_coral-gemini,sgc_coral-openai45,sgc_coral-openaio1","1,1,2",0.5288461538461539,0.4284987821872685,0.627508428100276,104,55,0.5663716814159292,0.4698655764900294,0.6593123718320077,113,64,29,48,16,9,26,16,33,40
"sgc_coral-anthropic10,sgc_coral-geminipro,sgc_coral-openai","4,1,1",0.5288461538461539,0.4284987821872685,0.627508428100276,104,55,0.48672566371681414,0.391592485688175,0.5825715848269355,113,55,28,38,15,8,27,17,34,50
"sgc_coral-anthropic10,sgc_coral-gemma,sgc_coral-openai4510","4,1,1",0.5288461538461539,0.4284987821872685,0.627508428100276,104,55,0.5132743362831859,0.41742841517306456,0.608407514311825,113,58,23,41,10,8,32,17,39,47
"sgc_coral-gemini10,sgc_coral-gemma,sgc_coral-openai4510","4,1,1",0.5288461538461539,0.4284987821872685,0.627508428100276,104,55,0.49557522123893805,0.40017620771878704,0.5912118116445175,113,56,23,39,10,8,32,17,39,49
"sgc_coral-anthropic,sgc_coral-geminipro10,sgc_coral-openai","1,1,1",0.5288461538461539,0.4284987821872685,0.627508428100276,104,55,0.48672566371681414,0.391592485688175,0.5825715848269355,113,55,32,44,19,14,23,11,30,44
"sgc_coral-gemini10,sgc_coral-gemini25,sgc_coral-geminipro10","4,2,1",0.5288461538461539,0.4284987821872685,0.627508428100276,104,55,0.3274336283185841,0.24210047134864673,0.4220658996882183,113,37,16,16,3,4,39,21,46,72
"sgc_coral-gemini,sgc_coral-gemma,sgc_coral-openai","1,1,1",0.5288461538461539,0.4284987821872685,0.627508428100276,104,55,0.5575221238938053,0.4610546518661339,0.6508999553070312,113,63,34,50,21,12,21,13,28,38
"sgc_coral-gemini,sgc_coral-gemini10,sgc_coral-gemma","1,4,1",0.5288461538461539,0.4284987821872685,0.627508428100276,104,55,0.4336283185840708,0.3406876281679922,0.5301344235099705,113,49,25,32,12,8,30,17,37,56
"sgc_coral-gemini25,sgc_coral-geminipro,sgc_coral-openaio1","2,1,2",0.5288461538461539,0.4284987821872685,0.627508428100276,104,55,0.4336283185840708,0.3406876281679922,0.5301344235099705,113,49,20,30,7,6,35,19,42,58
"sgc_coral-gemini10,sgc_coral-gemini25,sgc_coral-openailong","4,2,3",0.5288461538461539,0.4284987821872685,0.627508428100276,104,55,0.37168141592920356,0.28263100798002905,0.4676347962649451,113,42,20,21,7,4,35,21,42,67
"sgc_coral-gemini10,sgc_coral-geminipro10,sgc_coral-openai10o1","4,1,1",0.5288461538461539,0.4284987821872685,0.627508428100276,104,55,0.3274336283185841,0.24210047134864673,0.4220658996882183,113,37,23,21,10,9,32,16,39,67
"sgc_coral-anthropic,sgc_coral-openai10o1,sgc_coral-openailong","1,1,3",0.5288461538461539,0.4284987821872685,0.627508428100276,104,55,0.48672566371681414,0.391592485688175,0.5825715848269355,113,55,33,41,20,11,22,14,29,47
"sgc_coral-anthropic10,sgc_coral-anthropic37,sgc_coral-gemma","4,7,1",0.5288461538461539,0.4284987821872685,0.627508428100276,104,55,0.4690265486725664,0.3745099988696216,0.5652063110236246,113,53,19,34,6,6,36,19,43,54
"sgc_coral-anthropic10,sgc_coral-gemini10,sgc_coral-openaio1","4,4,2",0.5288461538461539,0.4284987821872685,0.627508428100276,104,55,0.3805309734513274,0.2908336209275553,0.4766535155216661,113,43,18,24,5,6,37,19,44,64
"sgc_coral-anthropic10,sgc_coral-gemini10,sgc_coral-openai4510","4,4,1",0.5288461538461539,0.4284987821872685,0.627508428100276,104,55,0.3893805309734513,0.29906724963482817,0.48564160577774956,113,44,19,25,6,6,36,19,43,63
"sgc_coral-anthropic10,sgc_coral-gemini10,sgc_coral-openai","4,4,1",0.5288461538461539,0.4284987821872685,0.627508428100276,104,55,0.3805309734513274,0.2908336209275553,0.4766535155216661,113,43,18,23,5,5,37,20,44,65
"sgc_coral-anthropic10,sgc_coral-gemini10,sgc_coral-geminipro10","4,4,1",0.5288461538461539,0.4284987821872685,0.627508428100276,104,55,0.37168141592920356,0.28263100798002905,0.4676347962649451,113,42,18,23,5,6,37,19,44,65
"sgc_coral-anthropic37,sgc_coral-openai4510,sgc_coral-openaio1","7,1,2",0.5288461538461539,0.4284987821872685,0.627508428100276,104,55,0.49557522123893805,0.40017620771878704,0.5912118116445175,113,56,21,33,8,2,34,23,41,55
"sgc_coral-gemini10,sgc_coral-geminipro,sgc_coral-openailong","4,1,3",0.5288461538461539,0.4284987821872685,0.627508428100276,104,55,0.45132743362831856,0.35754135758362804,0.5477275431896468,113,51,24,32,11,6,31,19,38,56
"sgc_coral-anthropic,sgc_coral-gemma,sgc_coral-openai10o1","1,1,1",0.5288461538461539,0.4284987821872685,0.627508428100276,104,55,0.49557522123893805,0.40017620771878704,0.5912118116445175,113,56,36,44,23,13,19,12,26,44
"sgc_coral-gemini10,sgc_coral-openai,sgc_coral-openaio1","4,1,2",0.5288461538461539,0.4284987821872685,0.627508428100276,104,55,0.4424778761061947,0.3491000446929689,0.5389453481338661,113,50,19,28,6,3,36,22,43,60
"sgc_coral-anthropic37,sgc_coral-openai10o1,sgc_coral-openaio1","7,1,2",0.5288461538461539,0.4284987821872685,0.627508428100276,104,55,0.4690265486725664,0.3745099988696216,0.5652063110236246,113,53,21,31,8,3,34,22,41,57
"sgc_coral-gemini25,sgc_coral-gemma,sgc_coral-openai4510","2,1,1",0.5288461538461539,0.4284987821872685,0.627508428100276,104,55,0.4778761061946903,0.38303706099768864,0.5739030980014965,113,54,22,36,9,7,33,18,40,52
"sgc_coral-anthropic,sgc_coral-openai4510,sgc_coral-openaio1","1,1,2",0.5288461538461539,0.4284987821872685,0.627508428100276,104,55,0.5486725663716814,0.4522724568103532,0.642458642416372,113,62,27,45,14,8,28,17,35,43
"sgc_coral-anthropic,sgc_coral-openai45,sgc_coral-openai4510","1,1,1",0.5288461538461539,0.4284987821872685,0.627508428100276,104,55,0.5309734513274337,0.4347936889763754,0.6254900011303783,113,60,33,49,20,14,22,11,29,39
"sgc_coral-anthropic,sgc_coral-gemini,sgc_coral-gemini10","1,1,4",0.5192307692307693,0.4190774389234318,0.6182607612874944,104,54,0.46017699115044247,0.3660113913185952,0.5564811572428492,113,52,28,35,16,8,26,17,34,53
"sgc_coral-geminipro,sgc_coral-openai,sgc_coral-openai45","1,1,1",0.5192307692307693,0.4190774389234318,0.6182607612874944,104,54,0.5132743362831859,0.41742841517306456,0.608407514311825,113,58,35,45,23,12,19,13,27,43
"sgc_coral-gemini,sgc_coral-openai,sgc_coral-openai4510","1,1,1",0.5192307692307693,0.4190774389234318,0.6182607612874944,104,54,0.5398230088495575,0.44351884275715087,0.6339886086814048,113,61,33,47,21,11,21,14,29,41
"sgc_coral-geminipro10,sgc_coral-openai,sgc_coral-openai10o1","1,1,1",0.5192307692307693,0.4190774389234318,0.6182607612874944,104,54,0.4778761061946903,0.38303706099768864,0.5739030980014965,113,54,30,39,18,10,24,15,32,49
"sgc_coral-geminipro,sgc_coral-openai45,sgc_coral-openaio1","1,1,2",0.5192307692307693,0.4190774389234318,0.6182607612874944,104,54,0.584070796460177,0.4875743523159756,0.6760496659713334,113,66,29,48,17,7,25,18,33,40
"sgc_coral-geminipro10,sgc_coral-openai,sgc_coral-openai45","1,1,1",0.5192307692307693,0.4190774389234318,0.6182607612874944,104,54,0.49557522123893805,0.40017620771878704,0.5912118116445175,113,56,31,45,19,14,23,11,31,43
"sgc_coral-gemini,sgc_coral-gemma,sgc_coral-openaio1","1,1,2",0.5192307692307693,0.4190774389234318,0.6182607612874944,104,54,0.5486725663716814,0.4522724568103532,0.642458642416372,113,62,25,45,13,8,29,17,37,43
"sgc_coral-gemini25,sgc_coral-openai,sgc_coral-openaio1","2,1,2",0.5192307692307693,0.4190774389234318,0.6182607612874944,104,54,0.4690265486725664,0.3745099988696216,0.5652063110236246,113,53,18,29,6,1,36,24,44,59
"sgc_coral-anthropic37,sgc_coral-gemini25,sgc_coral-openai4510","7,2,1",0.5192307692307693,0.4190774389234318,0.6182607612874944,104,54,0.40707964601769914,0.3156259583771482,0.5035273529945195,113,46,17,23,5,2,37,23,45,65
"sgc_coral-gemini10,sgc_coral-gemini25,sgc_coral-geminipro","4,2,1",0.5192307692307693,0.4190774389234318,0.6182607612874944,104,54,0.336283185840708,0.2501403603610025,0.4312447837432745,113,38,18,18,6,5,36,20,44,70
"sgc_coral-gemini,sgc_coral-geminipro,sgc_coral-gemma","1,1,1",0.5192307692307693,0.4190774389234318,0.6182607612874944,104,54,0.5398230088495575,0.44351884275715087,0.6339886086814048,113,61,33,47,21,11,21,14,29,41
"sgc_coral-gemini,sgc_coral-geminipro10,sgc_coral-openai4510","1,1,1",0.5192307692307693,0.4190774389234318,0.6182607612874944,104,54,0.4778761061946903,0.38303706099768864,0.5739030980014965,113,54,28,42,16,13,26,12,34,46
"sgc_coral-gemini,sgc_coral-geminipro,sgc_coral-openaio1","1,1,2",0.5192307692307693,0.4190774389234318,0.6182607612874944,104,54,0.5929203539823009,0.4964726470054805,0.6843740416228519,113,67,28,48,16,6,26,19,34,40
"sgc_coral-anthropic,sgc_coral-anthropic10,sgc_coral-gemini25","1,4,2",0.5192307692307693,0.4190774389234318,0.6182607612874944,104,54,0.4247787610619469,0.33230431287413453,0.5212945922025517,113,48,18,27,6,4,36,21,44,61
"sgc_coral-anthropic,sgc_coral-anthropic10,sgc_coral-geminipro","1,4,1",0.5192307692307693,0.4190774389234318,0.6182607612874944,104,54,0.49557522123893805,0.40017620771878704,0.5912118116445175,113,56,30,40,18,9,24,16,32,48
"sgc_coral-anthropic10,sgc_coral-gemini10,sgc_coral-geminipro","4,4,1",0.5192307692307693,0.4190774389234318,0.6182607612874944,104,54,0.3893805309734513,0.29906724963482817,0.48564160577774956,113,44,18,26,6,7,36,18,44,62
"sgc_coral-anthropic10,sgc_coral-geminipro,sgc_coral-gemma","4,1,1",0.5192307692307693,0.4190774389234318,0.6182607612874944,104,54,0.5132743362831859,0.41742841517306456,0.608407514311825,113,58,30,41,18,8,24,17,32,47
"sgc_coral-anthropic,sgc_coral-anthropic10,sgc_coral-openaio1","1,4,2",0.5192307692307693,0.4190774389234318,0.6182607612874944,104,54,0.4690265486725664,0.3745099988696216,0.5652063110236246,113,53,20,32,8,4,34,21,42,56
"sgc_coral-gemini,sgc_coral-gemini10,sgc_coral-geminipro","1,4,1",0.5192307692307693,0.4190774389234318,0.6182607612874944,104,54,0.46017699115044247,0.3660113913185952,0.5564811572428492,113,52,27,33,15,6,27,19,35,55
"sgc_coral-openai,sgc_coral-openai10o1,sgc_coral-openaio1","1,1,2",0.5192307692307693,0.4190774389234318,0.6182607612874944,104,54,0.5309734513274337,0.4347936889763754,0.6254900011303783,113,60,25,41,13,6,29,19,37,47
"sgc_coral-gemini,sgc_coral-gemini10,sgc_coral-openai4510","1,4,1",0.5192307692307693,0.4190774389234318,0.6182607612874944,104,54,0.4778761061946903,0.38303706099768864,0.5739030980014965,113,54,23,35,11,6,31,19,39,53
"sgc_coral-openai,sgc_coral-openai10,sgc_coral-openai10o1","1,1,1",0.5192307692307693,0.4190774389234318,0.6182607612874944,104,54,0.4690265486725664,0.3745099988696216,0.5652063110236246,113,53,34,41,22,13,20,12,28,47
"sgc_coral-gemini,sgc_coral-gemini25,sgc_coral-geminipro10","1,2,1",0.5192307692307693,0.4190774389234318,0.6182607612874944,104,54,0.4247787610619469,0.33230431287413453,0.5212945922025517,113,48,25,29,13,6,29,19,37,59
"sgc_coral-gemini,sgc_coral-gemini25,sgc_coral-gemma","1,2,1",0.5192307692307693,0.4190774389234318,0.6182607612874944,104,54,0.415929203539823,0.3239503340286666,0.5124256476840243,113,47,24,28,12,6,30,19,38,60
"sgc_coral-anthropic,sgc_coral-openai10o1,sgc_coral-openai45","1,1,1",0.5192307692307693,0.4190774389234318,0.6182607612874944,104,54,0.5486725663716814,0.4522724568103532,0.642458642416372,113,62,36,49,24,12,18,13,26,39
"sgc_coral-anthropic37,sgc_coral-gemini25,sgc_coral-gemma","7,2,1",0.5192307692307693,0.4190774389234318,0.6182607612874944,104,54,0.3805309734513274,0.2908336209275553,0.4766535155216661,113,43,17,22,5,4,37,21,45,66
"sgc_coral-anthropic37,sgc_coral-gemini25,sgc_coral-openai","7,2,1",0.5192307692307693,0.4190774389234318,0.6182607612874944,104,54,0.40707964601769914,0.3156259583771482,0.5035273529945195,113,46,17,22,5,1,37,24,45,66
"sgc_coral-anthropic10,sgc_coral-geminipro,sgc_coral-openai10o1","4,1,1",0.5192307692307693,0.4190774389234318,0.6182607612874944,104,54,0.5132743362831859,0.41742841517306456,0.608407514311825,113,58,28,41,16,8,26,17,34,47
"sgc_coral-gemma,sgc_coral-openai,sgc_coral-openailong","1,1,3",0.5192307692307693,0.4190774389234318,0.6182607612874944,104,54,0.5486725663716814,0.4522724568103532,0.642458642416372,113,62,30,47,18,10,24,15,32,41
"sgc_coral-gemma,sgc_coral-openai,sgc_coral-openai45","1,1,1",0.5192307692307693,0.4190774389234318,0.6182607612874944,104,54,0.5663716814159292,0.4698655764900294,0.6593123718320077,113,64,33,51,21,12,21,13,29,37
"sgc_coral-geminipro,sgc_coral-geminipro10,sgc_coral-openai10o1","1,1,1",0.5192307692307693,0.4190774389234318,0.6182607612874944,104,54,0.4424778761061947,0.3491000446929689,0.5389453481338661,113,50,33,37,21,12,21,13,29,51
"sgc_coral-gemini,sgc_coral-geminipro,sgc_coral-openai4510","1,1,1",0.5192307692307693,0.4190774389234318,0.6182607612874944,104,54,0.5486725663716814,0.4522724568103532,0.642458642416372,113,62,34,48,22,11,20,14,28,40
"sgc_coral-geminipro,sgc_coral-geminipro10,sgc_coral-openai4510","1,1,1",0.5192307692307693,0.4190774389234318,0.6182607612874944,104,54,0.504424778761062,0.4087881883554824,0.599823792281213,113,57,30,44,18,12,24,13,32,44
"sgc_coral-gemini25,sgc_coral-openai,sgc_coral-openai4510","2,1,1",0.5192307692307693,0.4190774389234318,0.6182607612874944,104,54,0.415929203539823,0.3239503340286666,0.5124256476840243,113,47,24,29,12,7,30,18,38,59
"sgc_coral-gemini10,sgc_coral-openai4510,sgc_coral-openaio1","4,1,2",0.5192307692307693,0.4190774389234318,0.6182607612874944,104,54,0.4690265486725664,0.3745099988696216,0.5652063110236246,113,53,18,32,6,4,36,21,44,56
"sgc_coral-anthropic,sgc_coral-gemini,sgc_coral-openaio1","1,1,2",0.5192307692307693,0.4190774389234318,0.6182607612874944,104,54,0.5575221238938053,0.4610546518661339,0.6508999553070312,113,63,30,46,18,8,24,17,32,42
"sgc_coral-gemini10,sgc_coral-geminipro,sgc_coral-openaio1","4,1,2",0.5192307692307693,0.4190774389234318,0.6182607612874944,104,54,0.4247787610619469,0.33230431287413453,0.5212945922025517,113,48,18,29,6,6,36,19,44,59
"sgc_coral-gemini10,sgc_coral-openai,sgc_coral-openai4510","4,1,1",0.5192307692307693,0.4190774389234318,0.6182607612874944,104,54,0.4247787610619469,0.33230431287413453,0.5212945922025517,113,48,23,32,11,9,31,16,39,56
"sgc_coral-gemini25,sgc_coral-openai45,sgc_coral-openaio1","2,1,2",0.5192307692307693,0.4190774389234318,0.6182607612874944,104,54,0.4778761061946903,0.38303706099768864,0.5739030980014965,113,54,20,34,8,5,34,20,42,54
"sgc_coral-gemini25,sgc_coral-openai10o1,sgc_coral-openaio1","2,1,2",0.5192307692307693,0.4190774389234318,0.6182607612874944,104,54,0.4336283185840708,0.3406876281679922,0.5301344235099705,113,49,20,27,8,3,34,22,42,61
"sgc_coral-anthropic,sgc_coral-geminipro,sgc_coral-openai4510","1,1,1",0.5192307692307693,0.4190774389234318,0.6182607612874944,104,54,0.5398230088495575,0.44351884275715087,0.6339886086814048,113,61,35,47,23,11,19,14,27,41
"sgc_coral-anthropic,sgc_coral-gemini,sgc_coral-openai10","1,1,1",0.5192307692307693,0.4190774389234318,0.6182607612874944,104,54,0.5132743362831859,0.41742841517306456,0.608407514311825,113,58,37,43,25,10,17,15,25,45
"sgc_coral-anthropic,sgc_coral-gemini,sgc_coral-openai10o1","1,1,1",0.5192307692307693,0.4190774389234318,0.6182607612874944,104,54,0.5132743362831859,0.41742841517306456,0.608407514311825,113,58,36,43,24,10,18,15,26,45
"sgc_coral-gemini10,sgc_coral-openai,sgc_coral-openai10","4,1,1",0.5192307692307693,0.4190774389234318,0.6182607612874944,104,54,0.4424778761061947,0.3491000446929689,0.5389453481338661,113,50,28,32,16,7,26,18,34,56
"sgc_coral-gemini25,sgc_coral-openai10,sgc_coral-openaio1","2,1,2",0.5192307692307693,0.4190774389234318,0.6182607612874944,104,54,0.4690265486725664,0.3745099988696216,0.5652063110236246,113,53,19,30,7,2,35,23,43,58
"sgc_coral-anthropic,sgc_coral-geminipro10,sgc_coral-openai45","1,1,1",0.5192307692307693,0.4190774389234318,0.6182607612874944,104,54,0.5132743362831859,0.41742841517306456,0.608407514311825,113,58,34,47,22,14,20,11,28,41
"sgc_coral-anthropic37,sgc_coral-gemini10,sgc_coral-gemini25","7,4,2",0.5096153846153846,0.4096908330346118,0.608978285037949,104,53,0.35398230088495575,0.26632066883004546,0.44950378631102667,113,40,16,17,5,2,37,23,46,71
"sgc_coral-gemini25,sgc_coral-geminipro,sgc_coral-openai45","2,1,1",0.5096153846153846,0.4096908330346118,0.608978285037949,104,53,0.48672566371681414,0.391592485688175,0.5825715848269355,113,55,27,36,16,6,26,19,35,52
"sgc_coral-anthropic,sgc_coral-openai,sgc_coral-openaio1","1,1,2",0.5096153846153846,0.4096908330346118,0.608978285037949,104,53,0.5486725663716814,0.4522724568103532,0.642458642416372,113,62,25,44,14,7,28,18,37,44
"sgc_coral-gemini,sgc_coral-openai,sgc_coral-openai45","1,1,1",0.5096153846153846,0.4096908330346118,0.608978285037949,104,53,0.5132743362831859,0.41742841517306456,0.608407514311825,113,58,35,45,24,12,18,13,27,43
"sgc_coral-geminipro,sgc_coral-openai10o1,sgc_coral-openai45","1,1,1",0.5096153846153846,0.4096908330346118,0.608978285037949,104,53,0.5575221238938053,0.4610546518661339,0.6508999553070312,113,63,32,50,21,12,21,13,30,38
"sgc_coral-gemini,sgc_coral-gemini25,sgc_coral-openai4510","1,2,1",0.5096153846153846,0.4096908330346118,0.608978285037949,104,53,0.4247787610619469,0.33230431287413453,0.5212945922025517,113,48,23,30,12,7,30,18,39,58
"sgc_coral-anthropic,sgc_coral-gemini25,sgc_coral-openai4510","1,2,1",0.5096153846153846,0.4096908330346118,0.608978285037949,104,53,0.48672566371681414,0.391592485688175,0.5825715848269355,113,55,25,37,14,7,28,18,37,51
"sgc_coral-gemini25,sgc_coral-geminipro,sgc_coral-openai10o1","2,1,1",0.5096153846153846,0.4096908330346118,0.608978285037949,104,53,0.45132743362831856,0.35754135758362804,0.5477275431896468,113,51,28,31,17,5,25,20,34,57
"sgc_coral-anthropic,sgc_coral-openai,sgc_coral-openai45","1,1,1",0.5096153846153846,0.4096908330346118,0.608978285037949,104,53,0.5929203539823009,0.4964726470054805,0.6843740416228519,113,67,35,54,24,12,18,13,27,34
"sgc_coral-openai,sgc_coral-openai4510,sgc_coral-openaio1","1,1,2",0.5096153846153846,0.4096908330346118,0.608978285037949,104,53,0.5398230088495575,0.44351884275715087,0.6339886086814048,113,61,24,44,13,8,29,17,38,44
"sgc_coral-anthropic,sgc_coral-gemini,sgc_coral-geminipro","1,1,1",0.5096153846153846,0.4096908330346118,0.608978285037949,104,53,0.5663716814159292,0.4698655764900294,0.6593123718320077,113,64,34,49,23,10,19,15,28,39
"sgc_coral-anthropic,sgc_coral-geminipro,sgc_coral-gemma","1,1,1",0.5096153846153846,0.4096908330346118,0.608978285037949,104,53,0.5663716814159292,0.4698655764900294,0.6593123718320077,113,64,36,50,25,11,17,14,26,38
"sgc_coral-anthropic,sgc_coral-anthropic10,sgc_coral-openai10o1","1,4,1",0.5096153846153846,0.4096908330346118,0.608978285037949,104,53,0.4424778761061947,0.3491000446929689,0.5389453481338661,113,50,26,36,15,11,27,14,36,52
"sgc_coral-geminipro10,sgc_coral-openai10o1,sgc_coral-openai4510","1,1,1",0.5096153846153846,0.4096908330346118,0.608978285037949,104,53,0.45132743362831856,0.35754135758362804,0.5477275431896468,113,51,28,41,17,15,25,10,34,47
"sgc_coral-anthropic10,sgc_coral-gemini,sgc_coral-openai","4,1,1",0.5096153846153846,0.4096908330346118,0.608978285037949,104,53,0.5309734513274337,0.4347936889763754,0.6254900011303783,113,60,26,39,15,4,27,21,36,49
"sgc_coral-anthropic10,sgc_coral-gemini10,sgc_coral-gemini25","4,4,2",0.5096153846153846,0.4096908330346118,0.608978285037949,104,53,0.3805309734513274,0.2908336209275553,0.4766535155216661,113,43,16,22,5,4,37,21,46,66
"sgc_coral-openai10o1,sgc_coral-openai45,sgc_coral-openai4510","1,1,1",0.5096153846153846,0.4096908330346118,0.608978285037949,104,53,0.5398230088495575,0.44351884275715087,0.6339886086814048,113,61,31,48,20,12,22,13,31,40
"sgc_coral-gemini,sgc_coral-gemini10,sgc_coral-gemini25","1,4,2",0.5096153846153846,0.4096908330346118,0.608978285037949,104,53,0.3274336283185841,0.24210047134864673,0.4220658996882183,113,37,18,18,7,6,35,19,44,70
"sgc_coral-gemini25,sgc_coral-openai10o1,sgc_coral-openai45","2,1,1",0.5096153846153846,0.4096908330346118,0.608978285037949,104,53,0.4336283185840708,0.3406876281679922,0.5301344235099705,113,49,25,31,14,7,28,18,37,57
"sgc_coral-openai10o1,sgc_coral-openai45,sgc_coral-openaio1","1,1,2",0.5096153846153846,0.4096908330346118,0.608978285037949,104,53,0.5663716814159292,0.4698655764900294,0.6593123718320077,113,64,25,48,14,9,28,16,37,40
"sgc_coral-geminipro,sgc_coral-gemma,sgc_coral-openai10o1","1,1,1",0.5096153846153846,0.4096908330346118,0.608978285037949,104,53,0.49557522123893805,0.40017620771878704,0.5912118116445175,113,56,32,45,21,14,21,11,30,43
"sgc_coral-anthropic37,sgc_coral-openai10o1,sgc_coral-openai4510","7,1,1",0.5096153846153846,0.4096908330346118,0.608978285037949,104,53,0.45132743362831856,0.35754135758362804,0.5477275431896468,113,51,25,33,14,7,28,18,37,55
"sgc_coral-openai10o1,sgc_coral-openai4510,sgc_coral-openaio1","1,1,2",0.5096153846153846,0.4096908330346118,0.608978285037949,104,53,0.5132743362831859,0.41742841517306456,0.608407514311825,113,58,25,39,14,6,28,19,37,49
"sgc_coral-gemma,sgc_coral-openai,sgc_coral-openaio1","1,1,2",0.5,0.4003389254006171,0.5996610745993829,104,52,0.5398230088495575,0.44351884275715087,0.6339886086814048,113,61,24,45,14,9,28,16,38,43
"sgc_coral-anthropic,sgc_coral-anthropic37,sgc_coral-openai","1,7,1",0.5,0.4003389254006171,0.5996610745993829,104,52,0.4778761061946903,0.38303706099768864,0.5739030980014965,113,54,25,33,15,4,27,21,37,55
"sgc_coral-anthropic10,sgc_coral-openai,sgc_coral-openai45","4,1,1",0.5,0.4003389254006171,0.5996610745993829,104,52,0.5575221238938053,0.4610546518661339,0.6508999553070312,113,63,26,46,16,8,26,17,36,42
"sgc_coral-gemini10,sgc_coral-geminipro,sgc_coral-openai4510","4,1,1",0.5,0.4003389254006171,0.5996610745993829,104,52,0.4424778761061947,0.3491000446929689,0.5389453481338661,113,50,20,34,10,9,32,16,42,54
"sgc_coral-gemma,sgc_coral-openai45,sgc_coral-openai4510","1,1,1",0.5,0.4003389254006171,0.5996610745993829,104,52,0.5752212389380531,0.4787054077974483,0.6676956871258655,113,65,31,54,21,14,21,11,31,34
"sgc_coral-gemini25,sgc_coral-geminipro,sgc_coral-openai","2,1,1",0.5,0.4003389254006171,0.5996610745993829,104,52,0.4424778761061947,0.3491000446929689,0.5389453481338661,113,50,25,31,15,6,27,19,37,57
"sgc_coral-gemini,sgc_coral-gemini10,sgc_coral-openai","1,4,1",0.5,0.4003389254006171,0.5996610745993829,104,52,0.45132743362831856,0.35754135758362804,0.5477275431896468,113,51,23,30,13,4,29,21,39,58
"sgc_coral-openai,sgc_coral-openai10,sgc_coral-openaio1","1,1,2",0.5,0.4003389254006171,0.5996610745993829,104,52,0.5309734513274337,0.4347936889763754,0.6254900011303783,113,60,28,41,18,6,24,19,34,47
"sgc_coral-gemini25,sgc_coral-openai,sgc_coral-openai10o1","2,1,1",0.5,0.4003389254006171,0.5996610745993829,104,52,0.4247787610619469,0.33230431287413453,0.5212945922025517,113,48,21,31,11,8,31,17,41,57
"sgc_coral-anthropic,sgc_coral-geminipro,sgc_coral-openai45","1,1,1",0.5,0.4003389254006171,0.5996610745993829,104,52,0.5752212389380531,0.4787054077974483,0.6676956871258655,113,65,34,52,24,12,18,13,28,36
"sgc_coral-geminipro,sgc_coral-openai10o1,sgc_coral-openaio1","1,1,2",0.5,0.4003389254006171,0.5996610745993829,104,52,0.5221238938053098,0.4260969019985035,0.6169629390023114,113,59,26,42,16,8,26,17,36,46
"sgc_coral-anthropic10,sgc_coral-gemma,sgc_coral-openai45","4,1,1",0.5,0.4003389254006171,0.5996610745993829,104,52,0.504424778761062,0.4087881883554824,0.599823792281213,113,57,28,43,18,11,24,14,34,45
"sgc_coral-anthropic,sgc_coral-gemini,sgc_coral-openai","1,1,1",0.5,0.4003389254006171,0.5996610745993829,104,52,0.5398230088495575,0.44351884275715087,0.6339886086814048,113,61,36,46,26,10,16,15,26,42
"sgc_coral-anthropic,sgc_coral-gemini,sgc_coral-openai45","1,1,1",0.5,0.4003389254006171,0.5996610745993829,104,52,0.5486725663716814,0.4522724568103532,0.642458642416372,113,62,34,49,24,12,18,13,28,39
"sgc_coral-gemini10,sgc_coral-geminipro,sgc_coral-openai","4,1,1",0.5,0.4003389254006171,0.5996610745993829,104,52,0.40707964601769914,0.3156259583771482,0.5035273529945195,113,46,24,29,14,8,28,17,38,59
"sgc_coral-gemini10,sgc_coral-gemini25,sgc_coral-openai45","4,2,1",0.5,0.4003389254006171,0.5996610745993829,104,52,0.3805309734513274,0.2908336209275553,0.4766535155216661,113,43,16,23,6,5,36,20,46,65
"sgc_coral-geminipro,sgc_coral-geminipro10,sgc_coral-gemma","1,1,1",0.5,0.4003389254006171,0.5996610745993829,104,52,0.5132743362831859,0.41742841517306456,0.608407514311825,113,58,31,46,21,13,21,12,31,42
"sgc_coral-gemini10,sgc_coral-gemini25,sgc_coral-openai10o1","4,2,1",0.5,0.4003389254006171,0.5996610745993829,104,52,0.3274336283185841,0.24210047134864673,0.4220658996882183,113,37,16,17,6,5,36,20,46,71
"sgc_coral-gemini,sgc_coral-openai4510,sgc_coral-openaio1","1,1,2",0.5,0.4003389254006171,0.5996610745993829,104,52,0.5663716814159292,0.4698655764900294,0.6593123718320077,113,64,22,45,12,6,30,19,40,43
"sgc_coral-anthropic,sgc_coral-gemini10,sgc_coral-openai","1,4,1",0.5,0.4003389254006171,0.5996610745993829,104,52,0.4424778761061947,0.3491000446929689,0.5389453481338661,113,50,23,31,13,6,29,19,39,57
"sgc_coral-gemini10,sgc_coral-gemini25,sgc_coral-openai","4,2,1",0.5,0.4003389254006171,0.5996610745993829,104,52,0.336283185840708,0.2501403603610025,0.4312447837432745,113,38,15,16,5,3,37,22,47,72
"sgc_coral-gemini,sgc_coral-gemma,sgc_coral-openai4510","1,1,1",0.5,0.4003389254006171,0.5996610745993829,104,52,0.5221238938053098,0.4260969019985035,0.6169629390023114,113,59,29,48,19,14,23,11,33,40
"sgc_coral-anthropic10,sgc_coral-gemma,sgc_coral-openai","4,1,1",0.5,0.4003389254006171,0.5996610745993829,104,52,0.5132743362831859,0.41742841517306456,0.608407514311825,113,58,25,42,15,9,27,16,37,46
"sgc_coral-gemini,sgc_coral-gemini25,sgc_coral-openai","1,2,1",0.49038461538461536,0.391021714962051,0.5903091669653882,104,51,0.4778761061946903,0.38303706099768864,0.5739030980014965,113,54,24,32,15,3,27,22,38,56
"sgc_coral-anthropic,sgc_coral-gemini25,sgc_coral-openaio1","1,2,2",0.49038461538461536,0.391021714962051,0.5903091669653882,104,51,0.40707964601769914,0.3156259583771482,0.5035273529945195,113,46,18,26,9,5,33,20,44,62
"sgc_coral-gemma,sgc_coral-openai10o1,sgc_coral-openai45","1,1,1",0.49038461538461536,0.391021714962051,0.5903091669653882,104,51,0.5309734513274337,0.4347936889763754,0.6254900011303783,113,60,33,48,24,13,18,12,29,40
"sgc_coral-gemini10,sgc_coral-geminipro,sgc_coral-gemma","4,1,1",0.49038461538461536,0.391021714962051,0.5903091669653882,104,51,0.4247787610619469,0.33230431287413453,0.5212945922025517,113,48,25,32,16,9,26,16,37,56
"sgc_coral-anthropic37,sgc_coral-openai,sgc_coral-openai10o1","7,1,1",0.49038461538461536,0.391021714962051,0.5903091669653882,104,51,0.4690265486725664,0.3745099988696216,0.5652063110236246,113,53,21,35,12,7,30,18,41,53
"sgc_coral-gemini,sgc_coral-gemini10,sgc_coral-openai10o1","1,4,1",0.49038461538461536,0.391021714962051,0.5903091669653882,104,51,0.37168141592920356,0.28263100798002905,0.4676347962649451,113,42,23,26,14,9,28,16,39,62
"sgc_coral-gemini25,sgc_coral-gemma,sgc_coral-openai45","2,1,1",0.49038461538461536,0.391021714962051,0.5903091669653882,104,51,0.4690265486725664,0.3745099988696216,0.5652063110236246,113,53,26,37,17,9,25,16,36,51
"sgc_coral-anthropic,sgc_coral-openai45,sgc_coral-openaio1","1,1,2",0.49038461538461536,0.391021714962051,0.5903091669653882,104,51,0.5752212389380531,0.4787054077974483,0.6676956871258655,113,65,25,49,16,9,26,16,37,39
"sgc_coral-geminipro,sgc_coral-openai45,sgc_coral-openai4510","1,1,1",0.49038461538461536,0.391021714962051,0.5903091669653882,104,51,0.5132743362831859,0.41742841517306456,0.608407514311825,113,58,32,48,23,15,19,10,30,40
"sgc_coral-geminipro,sgc_coral-openai,sgc_coral-openaio1","1,1,2",0.49038461538461536,0.391021714962051,0.5903091669653882,104,51,0.5309734513274337,0.4347936889763754,0.6254900011303783,113,60,23,42,14,7,28,18,39,46
"sgc_coral-gemini10,sgc_coral-openai10o1,sgc_coral-openaio1","4,1,2",0.49038461538461536,0.391021714962051,0.5903091669653882,104,51,0.4336283185840708,0.3406876281679922,0.5301344235099705,113,49,16,29,7,5,35,20,46,59
"sgc_coral-geminipro,sgc_coral-gemma,sgc_coral-openai45","1,1,1",0.49038461538461536,0.391021714962051,0.5903091669653882,104,51,0.5575221238938053,0.4610546518661339,0.6508999553070312,113,63,33,53,24,15,18,10,29,35
"sgc_coral-gemini10,sgc_coral-openai10o1,sgc_coral-openai45","4,1,1",0.49038461538461536,0.391021714962051,0.5903091669653882,104,51,0.415929203539823,0.3239503340286666,0.5124256476840243,113,47,23,31,14,9,28,16,39,57
"sgc_coral-geminipro,sgc_coral-geminipro10,sgc_coral-openai","1,1,1",0.49038461538461536,0.391021714962051,0.5903091669653882,104,51,0.4690265486725664,0.3745099988696216,0.5652063110236246,113,53,31,39,22,11,20,14,31,49
"sgc_coral-gemini10,sgc_coral-geminipro,sgc_coral-openai45","4,1,1",0.49038461538461536,0.391021714962051,0.5903091669653882,104,51,0.4778761061946903,0.38303706099768864,0.5739030980014965,113,54,27,37,18,8,24,17,35,51
"sgc_coral-gemini10,sgc_coral-openai45,sgc_coral-openaio1","4,1,2",0.49038461538461536,0.391021714962051,0.5903091669653882,104,51,0.49557522123893805,0.40017620771878704,0.5912118116445175,113,56,16,36,7,5,35,20,46,52
"sgc_coral-anthropic,sgc_coral-gemini10,sgc_coral-openai10o1","1,4,1",0.49038461538461536,0.391021714962051,0.5903091669653882,104,51,0.3893805309734513,0.29906724963482817,0.48564160577774956,113,44,25,30,16,11,26,14,37,58
"sgc_coral-gemini10,sgc_coral-geminipro,sgc_coral-openai10o1","4,1,1",0.49038461538461536,0.391021714962051,0.5903091669653882,104,51,0.4247787610619469,0.33230431287413453,0.5212945922025517,113,48,24,30,15,7,27,18,38,58
"sgc_coral-gemini,sgc_coral-openai,sgc_coral-openai10o1","1,1,1",0.49038461538461536,0.391021714962051,0.5903091669653882,104,51,0.5309734513274337,0.4347936889763754,0.6254900011303783,113,60,32,46,23,11,19,14,30,42
"sgc_coral-anthropic10,sgc_coral-geminipro,sgc_coral-openai45","4,1,1",0.49038461538461536,0.391021714962051,0.5903091669653882,104,51,0.5132743362831859,0.41742841517306456,0.608407514311825,113,58,29,43,20,10,22,15,33,45
"sgc_coral-anthropic,sgc_coral-gemini10,sgc_coral-openai4510","1,4,1",0.49038461538461536,0.391021714962051,0.5903091669653882,104,51,0.4690265486725664,0.3745099988696216,0.5652063110236246,113,53,24,36,15,8,27,17,38,52
"sgc_coral-anthropic,sgc_coral-openai,sgc_coral-openai4510","1,1,1",0.49038461538461536,0.391021714962051,0.5903091669653882,104,51,0.504424778761062,0.4087881883554824,0.599823792281213,113,57,30,43,21,11,21,14,32,45
"sgc_coral-anthropic10,sgc_coral-openai10o1,sgc_coral-openai4510","4,1,1",0.4807692307692308,0.38173923871250565,0.5809225610765683,104,50,0.49557522123893805,0.40017620771878704,0.5912118116445175,113,56,22,38,14,7,28,18,40,50
"sgc_coral-openai,sgc_coral-openai10o1,sgc_coral-openai45","1,1,1",0.4807692307692308,0.38173923871250565,0.5809225610765683,104,50,0.5132743362831859,0.41742841517306456,0.608407514311825,113,58,31,46,23,13,19,12,31,42
"sgc_coral-geminipro,sgc_coral-openai,sgc_coral-openai4510","1,1,1",0.4807692307692308,0.38173923871250565,0.5809225610765683,104,50,0.5309734513274337,0.4347936889763754,0.6254900011303783,113,60,29,45,21,10,21,15,33,43
"sgc_coral-anthropic,sgc_coral-gemini10,sgc_coral-openaio1","1,4,2",0.4807692307692308,0.38173923871250565,0.5809225610765683,104,50,0.4424778761061947,0.3491000446929689,0.5389453481338661,113,50,17,29,9,4,33,21,45,59
"sgc_coral-anthropic37,sgc_coral-gemma,sgc_coral-openai","7,1,1",0.4807692307692308,0.38173923871250565,0.5809225610765683,104,50,0.4690265486725664,0.3745099988696216,0.5652063110236246,113,53,24,36,16,8,26,17,38,52
"sgc_coral-anthropic,sgc_coral-gemini10,sgc_coral-openai45","1,4,1",0.4807692307692308,0.38173923871250565,0.5809225610765683,104,50,0.45132743362831856,0.35754135758362804,0.5477275431896468,113,51,24,36,16,10,26,15,38,52
"sgc_coral-anthropic37,sgc_coral-gemma,sgc_coral-openai45","7,1,1",0.4807692307692308,0.38173923871250565,0.5809225610765683,104,50,0.504424778761062,0.4087881883554824,0.599823792281213,113,57,26,42,18,10,24,15,36,46
"sgc_coral-gemini25,sgc_coral-openai10o1,sgc_coral-openai4510","2,1,1",0.4807692307692308,0.38173923871250565,0.5809225610765683,104,50,0.4247787610619469,0.33230431287413453,0.5212945922025517,113,48,21,30,13,7,29,18,41,58
"sgc_coral-gemini10,sgc_coral-gemma,sgc_coral-openai","4,1,1",0.4807692307692308,0.38173923871250565,0.5809225610765683,104,50,0.4690265486725664,0.3745099988696216,0.5652063110236246,113,53,22,36,14,8,28,17,40,52
"sgc_coral-gemini10,sgc_coral-openai10o1,sgc_coral-openai4510","4,1,1",0.4807692307692308,0.38173923871250565,0.5809225610765683,104,50,0.4247787610619469,0.33230431287413453,0.5212945922025517,113,48,21,30,13,7,29,18,41,58
"sgc_coral-geminipro,sgc_coral-gemma,sgc_coral-openaio1","1,1,2",0.4807692307692308,0.38173923871250565,0.5809225610765683,104,50,0.584070796460177,0.4875743523159756,0.6760496659713334,113,66,26,48,18,7,24,18,36,40
"sgc_coral-anthropic,sgc_coral-gemini10,sgc_coral-gemini25","1,4,2",0.4807692307692308,0.38173923871250565,0.5809225610765683,104,50,0.34513274336283184,0.2582139731102288,0.44039054896588103,113,39,15,18,7,4,35,21,47,70
"sgc_coral-gemma,sgc_coral-openai10o1,sgc_coral-openai4510","1,1,1",0.4807692307692308,0.38173923871250565,0.5809225610765683,104,50,0.5132743362831859,0.41742841517306456,0.608407514311825,113,58,29,46,21,13,21,12,33,42
"sgc_coral-gemini10,sgc_coral-openai,sgc_coral-openai10o1","4,1,1",0.4807692307692308,0.38173923871250565,0.5809225610765683,104,50,0.4336283185840708,0.3406876281679922,0.5301344235099705,113,49,20,32,12,8,30,17,42,56
"sgc_coral-gemini,sgc_coral-openai10o1,sgc_coral-openai45","1,1,1",0.4807692307692308,0.38173923871250565,0.5809225610765683,104,50,0.5309734513274337,0.4347936889763754,0.6254900011303783,113,60,32,47,24,12,18,13,30,41
"sgc_coral-gemini,sgc_coral-geminipro,sgc_coral-openai","1,1,1",0.4807692307692308,0.38173923871250565,0.5809225610765683,104,50,0.5752212389380531,0.4787054077974483,0.6676956871258655,113,65,34,48,26,8,16,17,28,40
"sgc_coral-geminipro,sgc_coral-gemma,sgc_coral-openai","1,1,1",0.47115384615384615,0.37249157189972404,0.5715012178127314,104,49,0.5221238938053098,0.4260969019985035,0.6169629390023114,113,59,29,45,22,11,20,14,33,43
"sgc_coral-gemini25,sgc_coral-openai,sgc_coral-openai45","2,1,1",0.47115384615384615,0.37249157189972404,0.5715012178127314,104,49,0.48672566371681414,0.391592485688175,0.5825715848269355,113,55,25,38,18,8,24,17,37,50
"sgc_coral-gemini,sgc_coral-gemma,sgc_coral-openai10o1","1,1,1",0.47115384615384615,0.37249157189972404,0.5715012178127314,104,49,0.5398230088495575,0.44351884275715087,0.6339886086814048,113,61,31,47,24,11,18,14,31,41
"sgc_coral-openai,sgc_coral-openai45,sgc_coral-openai4510","1,1,1",0.47115384615384615,0.37249157189972404,0.5715012178127314,104,49,0.584070796460177,0.4875743523159756,0.6760496659713334,113,66,28,52,21,11,21,14,34,36
"sgc_coral-anthropic,sgc_coral-gemma,sgc_coral-openai","1,1,1",0.47115384615384615,0.37249157189972404,0.5715012178127314,104,49,0.504424778761062,0.4087881883554824,0.599823792281213,113,57,31,44,24,12,18,13,31,44
"sgc_coral-gemini10,sgc_coral-openai,sgc_coral-openai45","4,1,1",0.47115384615384615,0.37249157189972404,0.5715012178127314,104,49,0.4778761061946903,0.38303706099768864,0.5739030980014965,113,54,22,37,15,8,27,17,40,51
"sgc_coral-gemma,sgc_coral-openai45,sgc_coral-openaio1","1,1,2",0.47115384615384615,0.37249157189972404,0.5715012178127314,104,49,0.5752212389380531,0.4787054077974483,0.6676956871258655,113,65,26,51,19,11,23,14,36,37
"sgc_coral-gemini,sgc_coral-openai,sgc_coral-openaio1","1,1,2",0.47115384615384615,0.37249157189972404,0.5715012178127314,104,49,0.584070796460177,0.4875743523159756,0.6760496659713334,113,66,23,44,16,3,26,22,39,44
"sgc_coral-anthropic,sgc_coral-gemini25,sgc_coral-openai10o1","1,2,1",0.47115384615384615,0.37249157189972404,0.5715012178127314,104,49,0.40707964601769914,0.3156259583771482,0.5035273529945195,113,46,24,29,17,8,25,17,38,59
"sgc_coral-gemma,sgc_coral-openai,sgc_coral-openai4510","1,1,1",0.47115384615384615,0.37249157189972404,0.5715012178127314,104,49,0.5752212389380531,0.4787054077974483,0.6676956871258655,113,65,28,49,21,9,21,16,34,39
"sgc_coral-openai,sgc_coral-openai45,sgc_coral-openaio1","1,1,2",0.47115384615384615,0.37249157189972404,0.5715012178127314,104,49,0.5309734513274337,0.4347936889763754,0.6254900011303783,113,60,23,43,16,8,26,17,39,45
"sgc_coral-gemini25,sgc_coral-gemma,sgc_coral-openai","2,1,1",0.46153846153846156,0.363278828438305,0.5620450597759874,104,48,0.4424778761061947,0.3491000446929689,0.5389453481338661,113,50,22,34,16,9,26,16,40,54
"sgc_coral-anthropic,sgc_coral-gemini25,sgc_coral-openai","1,2,1",0.46153846153846156,0.363278828438305,0.5620450597759874,104,48,0.4336283185840708,0.3406876281679922,0.5301344235099705,113,49,21,29,15,5,27,20,41,59
"sgc_coral-geminipro,sgc_coral-gemma,sgc_coral-openai4510","1,1,1",0.46153846153846156,0.363278828438305,0.5620450597759874,104,48,0.5132743362831859,0.41742841517306456,0.608407514311825,113,58,30,45,24,12,18,13,32,43
"sgc_coral-openai,sgc_coral-openai10o1,sgc_coral-openai4510","1,1,1",0.46153846153846156,0.363278828438305,0.5620450597759874,104,48,0.4336283185840708,0.3406876281679922,0.5301344235099705,113,49,26,36,20,12,22,13,36,52
"sgc_coral-geminipro,sgc_coral-openai,sgc_coral-openai10o1","1,1,1",0.4519230769230769,0.35410116153924587,0.5525539708619385,104,47,0.504424778761062,0.4087881883554824,0.599823792281213,113,57,30,43,25,11,17,14,32,45
"sgc_coral-anthropic,sgc_coral-geminipro,sgc_coral-openai","1,1,1",0.4519230769230769,0.35410116153924587,0.5525539708619385,104,47,0.49557522123893805,0.40017620771878704,0.5912118116445175,113,56,32,43,27,12,15,13,30,45
"sgc_coral-anthropic,sgc_coral-openai,sgc_coral-openai10o1","1,1,1",0.4519230769230769,0.35410116153924587,0.5525539708619385,104,47,0.4690265486725664,0.3745099988696216,0.5652063110236246,113,53,30,39,25,11,17,14,32,49
"sgc_coral-gemini10,sgc_coral-gemma,sgc_coral-openai45","4,1,1",0.4519230769230769,0.35410116153924587,0.5525539708619385,104,47,0.4690265486725664,0.3745099988696216,0.5652063110236246,113,53,23,38,18,10,24,15,39,50
"sgc_coral-gemini,sgc_coral-geminipro,sgc_coral-openai10o1","1,1,1",0.4423076923076923,0.34495876456449964,0.5430277956134092,104,46,0.5309734513274337,0.4347936889763754,0.6254900011303783,113,60,30,45,26,10,16,15,32,43
"sgc_coral-gemma,sgc_coral-openai,sgc_coral-openai10o1","1,1,1",0.41346153846153844,0.3177457537506023,0.5142365870048873,104,43,0.46017699115044247,0.3660113913185952,0.5564811572428492,113,52,25,41,24,14,18,11,37,47
