models,model_rounds,validation_accuracy,validation_lower_bound,validation_upper_bound,validation_total,validation_correct,test_accuracy,test_lower_bound,test_upper_bound,test_total,test_correct,validation_TP,test_TP,validation_FP,test_FP,validation_TN,test_TN,validation_FN,test_FN
"wisconsin_exoplanets-openai,wisconsin_exoplanets-openai45,wisconsin_exoplanets-openailong","6,4,4",0.96,0.8628623743960326,0.9951185665738356,50,48,0.8421052631578947,0.7213173699312707,0.9251688307994875,57,48,12,21,1,1,36,27,1,8
"wisconsin_exoplanets-openai,wisconsin_exoplanets-openai10,wisconsin_exoplanets-openai45","6,5,4",0.96,0.8628623743960326,0.9951185665738356,50,48,0.8421052631578947,0.7213173699312707,0.9251688307994875,57,48,12,21,1,1,36,27,1,8
"wisconsin_exoplanets-openai,wisconsin_exoplanets-openai10,wisconsin_exoplanets-openailong","6,5,4",0.96,0.8628623743960326,0.9951185665738356,50,48,0.8421052631578947,0.7213173699312707,0.9251688307994875,57,48,12,21,1,1,36,27,1,8
"wisconsin_exoplanets-openai,wisconsin_exoplanets-openaio1,wisconsin_exoplanets-qwq","6,2,1",0.96,0.8628623743960326,0.9951185665738356,50,48,0.7894736842105263,0.6611299420734731,0.8862097756836405,57,45,12,19,1,2,36,26,1,10
"wisconsin_exoplanets-openai,wisconsin_exoplanets-openaio1,wisconsin_exoplanets-phi","6,2,1",0.96,0.8628623743960326,0.9951185665738356,50,48,0.8245614035087719,0.7009423405431865,0.9125267711897262,57,47,12,20,1,1,36,27,1,9
"wisconsin_exoplanets-openai,wisconsin_exoplanets-openai4510,wisconsin_exoplanets-qwq","6,2,1",0.96,0.8628623743960326,0.9951185665738356,50,48,0.8421052631578947,0.7213173699312707,0.9251688307994875,57,48,12,21,1,1,36,27,1,8
"wisconsin_exoplanets-openai,wisconsin_exoplanets-openai10o1,wisconsin_exoplanets-openailong","6,5,4",0.96,0.8628623743960326,0.9951185665738356,50,48,0.8421052631578947,0.7213173699312707,0.9251688307994875,57,48,12,21,1,1,36,27,1,8
"wisconsin_exoplanets-openai,wisconsin_exoplanets-openai4510,wisconsin_exoplanets-openaio1","6,2,2",0.96,0.8628623743960326,0.9951185665738356,50,48,0.8245614035087719,0.7009423405431865,0.9125267711897262,57,47,12,20,1,1,36,27,1,9
"wisconsin_exoplanets-openai,wisconsin_exoplanets-openai10o1,wisconsin_exoplanets-openai45","6,5,4",0.96,0.8628623743960326,0.9951185665738356,50,48,0.8245614035087719,0.7009423405431865,0.9125267711897262,57,47,12,21,1,2,36,26,1,8
"wisconsin_exoplanets-anthropic37,wisconsin_exoplanets-geminipro10,wisconsin_exoplanets-openaio1","2,3,2",0.9523809523809523,0.8670815992518494,0.9900700488492667,63,60,0.7121212121212122,0.5874932401392494,0.816959774581892,66,47,19,16,0,3,41,31,3,16
"wisconsin_exoplanets-anthropic37,wisconsin_exoplanets-openai4510,wisconsin_exoplanets-openaio1","2,2,2",0.9523809523809523,0.8670815992518494,0.9900700488492667,63,60,0.8484848484848485,0.7389589287110891,0.9248753700606944,66,56,20,26,1,4,40,30,2,6
"wisconsin_exoplanets-anthropic37,wisconsin_exoplanets-geminipro,wisconsin_exoplanets-openaio1","2,2,2",0.9523809523809523,0.8670815992518494,0.9900700488492667,63,60,0.7121212121212122,0.5874932401392494,0.816959774581892,66,47,19,16,0,3,41,31,3,16
"wisconsin_exoplanets-anthropic,wisconsin_exoplanets-anthropic3710,wisconsin_exoplanets-deepseek","2,5,1",0.9523809523809523,0.8670815992518494,0.9900700488492667,63,60,0.8333333333333334,0.7213265468376222,0.9137520659512851,66,55,22,27,3,6,38,28,0,5
"wisconsin_exoplanets-anthropic37,wisconsin_exoplanets-anthropic3710,wisconsin_exoplanets-deepseek","2,5,1",0.9523809523809523,0.8670815992518494,0.9900700488492667,63,60,0.8484848484848485,0.7389589287110891,0.9248753700606944,66,56,21,30,2,8,39,26,1,2
"wisconsin_exoplanets-openai,wisconsin_exoplanets-openai10,wisconsin_exoplanets-openai10o1","6,5,5",0.94,0.8345180533962271,0.9874514121646659,50,47,0.8421052631578947,0.7213173699312707,0.9251688307994875,57,48,12,21,2,1,35,27,1,8
"wisconsin_exoplanets-openai,wisconsin_exoplanets-openai4510,wisconsin_exoplanets-openailong","6,2,4",0.94,0.8345180533962271,0.9874514121646659,50,47,0.8596491228070176,0.7420546161318784,0.937405109882715,57,49,12,22,2,1,35,27,1,7
"wisconsin_exoplanets-openai,wisconsin_exoplanets-openai45,wisconsin_exoplanets-openai4510","6,4,2",0.94,0.8345180533962271,0.9874514121646659,50,47,0.8421052631578947,0.7213173699312707,0.9251688307994875,57,48,12,22,2,2,35,26,1,7
"wisconsin_exoplanets-openai,wisconsin_exoplanets-openai10o1,wisconsin_exoplanets-openaio1","6,5,2",0.94,0.8345180533962271,0.9874514121646659,50,47,0.8070175438596491,0.6808902137314417,0.8995277714022677,57,46,12,21,2,3,35,25,1,8
"wisconsin_exoplanets-openai,wisconsin_exoplanets-openai10o1,wisconsin_exoplanets-openai4510","6,5,2",0.94,0.8345180533962271,0.9874514121646659,50,47,0.8421052631578947,0.7213173699312707,0.9251688307994875,57,48,12,21,2,1,35,27,1,8
"wisconsin_exoplanets-anthropic37,wisconsin_exoplanets-anthropic3710,wisconsin_exoplanets-llama","2,5,2",0.9365079365079365,0.8453393226046225,0.9824312067366454,63,59,0.7121212121212122,0.5874932401392494,0.816959774581892,66,47,21,28,3,15,38,19,1,4
"wisconsin_exoplanets-anthropic,wisconsin_exoplanets-anthropic37,wisconsin_exoplanets-anthropic3710","2,2,5",0.9365079365079365,0.8453393226046225,0.9824312067366454,63,59,0.8484848484848485,0.7389589287110891,0.9248753700606944,66,56,22,28,4,6,37,28,0,4
"wisconsin_exoplanets-anthropic37,wisconsin_exoplanets-gemini10,wisconsin_exoplanets-openaio1","2,2,2",0.9365079365079365,0.8453393226046225,0.9824312067366454,63,59,0.7121212121212122,0.5874932401392494,0.816959774581892,66,47,18,16,0,3,41,31,4,16
"wisconsin_exoplanets-anthropic37,wisconsin_exoplanets-anthropic3710,wisconsin_exoplanets-openai","2,5,6",0.9365079365079365,0.8453393226046225,0.9824312067366454,63,59,0.7424242424242424,0.6199387593265298,0.8422336207426879,66,49,22,29,4,14,37,20,0,3
"wisconsin_exoplanets-anthropic3710,wisconsin_exoplanets-openai4510,wisconsin_exoplanets-openaio1","5,2,2",0.9365079365079365,0.8453393226046225,0.9824312067366454,63,59,0.8636363636363636,0.7568586684861609,0.9357018153567447,66,57,19,26,1,3,40,31,3,6
"wisconsin_exoplanets-anthropic37,wisconsin_exoplanets-gemini,wisconsin_exoplanets-openai4510","2,7,2",0.9365079365079365,0.8453393226046225,0.9824312067366454,63,59,0.7878787878787878,0.6697885403521799,0.8788980677448571,66,52,19,23,1,5,40,29,3,9
"wisconsin_exoplanets-anthropic37,wisconsin_exoplanets-anthropic3710,wisconsin_exoplanets-gemini","2,5,7",0.9365079365079365,0.8453393226046225,0.9824312067366454,63,59,0.8333333333333334,0.7213265468376222,0.9137520659512851,66,55,21,29,3,8,38,26,1,3
"wisconsin_exoplanets-anthropic37,wisconsin_exoplanets-anthropic3710,wisconsin_exoplanets-openaio1","2,5,2",0.9365079365079365,0.8453393226046225,0.9824312067366454,63,59,0.8181818181818182,0.7039345441700697,0.9023647979841516,66,54,21,28,3,8,38,26,1,4
"wisconsin_exoplanets-anthropic37,wisconsin_exoplanets-gemini,wisconsin_exoplanets-openaio1","2,7,2",0.9206349206349206,0.8244240502751521,0.9737276593559724,63,58,0.6818181818181818,0.5556078292305275,0.7911016327585585,66,45,20,21,3,10,38,24,2,11
"wisconsin_exoplanets-anthropic37,wisconsin_exoplanets-openai45,wisconsin_exoplanets-openailong","2,4,4",0.9206349206349206,0.8244240502751521,0.9737276593559724,63,58,0.7424242424242424,0.6199387593265298,0.8422336207426879,66,49,21,28,4,13,37,21,1,4
"wisconsin_exoplanets-anthropic37,wisconsin_exoplanets-openai45,wisconsin_exoplanets-openai4510","2,4,2",0.9206349206349206,0.8244240502751521,0.9737276593559724,63,58,0.7575757575757576,0.6363888076622838,0.8546316735018541,66,50,21,28,4,12,37,22,1,4
"wisconsin_exoplanets-anthropic37,wisconsin_exoplanets-gemini10,wisconsin_exoplanets-openai","2,2,6",0.9206349206349206,0.8244240502751521,0.9737276593559724,63,58,0.7878787878787878,0.6697885403521799,0.8788980677448571,66,52,21,28,4,10,37,24,1,4
"wisconsin_exoplanets-anthropic3710,wisconsin_exoplanets-openai,wisconsin_exoplanets-openai4510","5,6,2",0.9206349206349206,0.8244240502751521,0.9737276593559724,63,58,0.8333333333333334,0.7213265468376222,0.9137520659512851,66,55,19,28,2,7,39,27,3,4
"wisconsin_exoplanets-anthropic,wisconsin_exoplanets-anthropic3710,wisconsin_exoplanets-openai4510","2,5,2",0.9206349206349206,0.8244240502751521,0.9737276593559724,63,58,0.8939393939393939,0.793606517867613,0.9562815509014071,66,59,19,28,2,3,39,31,3,4
"wisconsin_exoplanets-anthropic37,wisconsin_exoplanets-geminipro,wisconsin_exoplanets-openai45","2,2,4",0.9206349206349206,0.8244240502751521,0.9737276593559724,63,58,0.7424242424242424,0.6199387593265298,0.8422336207426879,66,49,22,28,5,13,36,21,0,4
"wisconsin_exoplanets-anthropic37,wisconsin_exoplanets-gemini10,wisconsin_exoplanets-openai45","2,2,4",0.9206349206349206,0.8244240502751521,0.9737276593559724,63,58,0.7575757575757576,0.6363888076622838,0.8546316735018541,66,50,21,28,4,12,37,22,1,4
"wisconsin_exoplanets-anthropic37,wisconsin_exoplanets-geminipro,wisconsin_exoplanets-openai","2,2,6",0.9206349206349206,0.8244240502751521,0.9737276593559724,63,58,0.7727272727272727,0.6530018980228203,0.8668572164845951,66,51,22,28,5,11,36,23,0,4
"wisconsin_exoplanets-anthropic,wisconsin_exoplanets-openai4510,wisconsin_exoplanets-openaio1","2,2,2",0.9206349206349206,0.8244240502751521,0.9737276593559724,63,58,0.8333333333333334,0.7213265468376222,0.9137520659512851,66,55,19,24,2,3,39,31,3,8
"wisconsin_exoplanets-anthropic37,wisconsin_exoplanets-anthropic3710,wisconsin_exoplanets-llamaphi","2,5,1",0.9206349206349206,0.8244240502751521,0.9737276593559724,63,58,0.7272727272727273,0.6036427957562946,0.8296733838204806,66,48,22,30,5,16,36,18,0,2
"wisconsin_exoplanets-openai,wisconsin_exoplanets-openai45,wisconsin_exoplanets-openaio1","6,4,2",0.92,0.8076572164040372,0.9777720363450703,50,46,0.8070175438596491,0.6808902137314417,0.8995277714022677,57,46,12,22,3,4,34,24,1,7
"wisconsin_exoplanets-openai,wisconsin_exoplanets-phi,wisconsin_exoplanets-qwq","6,1,1",0.92,0.8076572164040372,0.9777720363450703,50,46,0.8245614035087719,0.7009423405431865,0.9125267711897262,57,47,12,21,3,2,34,26,1,8
"wisconsin_exoplanets-openai,wisconsin_exoplanets-openai10,wisconsin_exoplanets-openai4510","6,5,2",0.92,0.8076572164040372,0.9777720363450703,50,46,0.8596491228070176,0.7420546161318784,0.937405109882715,57,49,12,22,3,1,34,27,1,7
"wisconsin_exoplanets-openai,wisconsin_exoplanets-openailong,wisconsin_exoplanets-openaio1","6,4,2",0.92,0.8076572164040372,0.9777720363450703,50,46,0.8245614035087719,0.7009423405431865,0.9125267711897262,57,47,12,22,3,3,34,25,1,7
"wisconsin_exoplanets-openai,wisconsin_exoplanets-openai4510,wisconsin_exoplanets-phi","6,2,1",0.92,0.8076572164040372,0.9777720363450703,50,46,0.8421052631578947,0.7213173699312707,0.9251688307994875,57,48,11,21,2,1,35,27,2,8
"wisconsin_exoplanets-openai10,wisconsin_exoplanets-openailong,wisconsin_exoplanets-openaio1","5,4,2",0.9056603773584906,0.7934146749949895,0.9686531942713469,53,48,0.8714285714285714,0.7699116098309631,0.9394866858096107,70,61,18,21,1,6,30,40,4,3
"wisconsin_exoplanets-openai10,wisconsin_exoplanets-openailong,wisconsin_exoplanets-phi","5,4,1",0.9056603773584906,0.7934146749949895,0.9686531942713469,53,48,0.8714285714285714,0.7699116098309631,0.9394866858096107,70,61,18,21,1,6,30,40,4,3
"wisconsin_exoplanets-openai10,wisconsin_exoplanets-openai4510,wisconsin_exoplanets-openailong","5,2,4",0.9056603773584906,0.7934146749949895,0.9686531942713469,53,48,0.8714285714285714,0.7699116098309631,0.9394866858096107,70,61,18,21,1,6,30,40,4,3
"wisconsin_exoplanets-anthropic3710,wisconsin_exoplanets-gemini10,wisconsin_exoplanets-openailong","5,2,4",0.9047619047619048,0.804143979441893,0.964240988134667,63,57,0.8181818181818182,0.7039345441700697,0.9023647979841516,66,54,18,28,2,8,39,26,4,4
"wisconsin_exoplanets-anthropic37,wisconsin_exoplanets-geminipro10,wisconsin_exoplanets-openai45","2,3,4",0.9047619047619048,0.804143979441893,0.964240988134667,63,57,0.7424242424242424,0.6199387593265298,0.8422336207426879,66,49,22,28,6,13,35,21,0,4
"wisconsin_exoplanets-anthropic37,wisconsin_exoplanets-llamaphi,wisconsin_exoplanets-openai","2,1,6",0.9047619047619048,0.804143979441893,0.964240988134667,63,57,0.7575757575757576,0.6363888076622838,0.8546316735018541,66,50,21,28,5,12,36,22,1,4
"wisconsin_exoplanets-anthropic3710,wisconsin_exoplanets-gemini10,wisconsin_exoplanets-openai45","5,2,4",0.9047619047619048,0.804143979441893,0.964240988134667,63,57,0.8333333333333334,0.7213265468376222,0.9137520659512851,66,55,18,28,2,7,39,27,4,4
"wisconsin_exoplanets-anthropic37,wisconsin_exoplanets-llama,wisconsin_exoplanets-openai4510","2,2,2",0.9047619047619048,0.804143979441893,0.964240988134667,63,57,0.7121212121212122,0.5874932401392494,0.816959774581892,66,47,17,21,1,8,40,26,5,11
"wisconsin_exoplanets-anthropic37,wisconsin_exoplanets-openai10,wisconsin_exoplanets-openai45","2,5,4",0.9047619047619048,0.804143979441893,0.964240988134667,63,57,0.7575757575757576,0.6363888076622838,0.8546316735018541,66,50,21,29,5,13,36,21,1,3
"wisconsin_exoplanets-anthropic37,wisconsin_exoplanets-gemini10,wisconsin_exoplanets-openailong","2,2,4",0.9047619047619048,0.804143979441893,0.964240988134667,63,57,0.7424242424242424,0.6199387593265298,0.8422336207426879,66,49,20,28,4,13,37,21,2,4
"wisconsin_exoplanets-anthropic37,wisconsin_exoplanets-openai,wisconsin_exoplanets-openailong","2,6,4",0.9047619047619048,0.804143979441893,0.964240988134667,63,57,0.7575757575757576,0.6363888076622838,0.8546316735018541,66,50,21,29,5,13,36,21,1,3
"wisconsin_exoplanets-anthropic37,wisconsin_exoplanets-geminipro10,wisconsin_exoplanets-openai","2,3,6",0.9047619047619048,0.804143979441893,0.964240988134667,63,57,0.7727272727272727,0.6530018980228203,0.8668572164845951,66,51,22,28,6,11,35,23,0,4
"wisconsin_exoplanets-anthropic37,wisconsin_exoplanets-openai,wisconsin_exoplanets-openai4510","2,6,2",0.9047619047619048,0.804143979441893,0.964240988134667,63,57,0.803030303030303,0.6867611541519056,0.8907397343822825,66,53,21,29,5,10,36,24,1,3
"wisconsin_exoplanets-anthropic3710,wisconsin_exoplanets-llamaphi,wisconsin_exoplanets-openai","5,1,6",0.9047619047619048,0.804143979441893,0.964240988134667,63,57,0.8636363636363636,0.7568586684861609,0.9357018153567447,66,57,18,29,2,6,39,28,4,3
"wisconsin_exoplanets-anthropic37,wisconsin_exoplanets-llamaphi,wisconsin_exoplanets-openai10","2,1,5",0.9047619047619048,0.804143979441893,0.964240988134667,63,57,0.7727272727272727,0.6530018980228203,0.8668572164845951,66,51,21,30,5,13,36,21,1,2
"wisconsin_exoplanets-anthropic37,wisconsin_exoplanets-llamaphi,wisconsin_exoplanets-openai10o1","2,1,5",0.9047619047619048,0.804143979441893,0.964240988134667,63,57,0.7727272727272727,0.6530018980228203,0.8668572164845951,66,51,21,30,5,13,36,21,1,2
"wisconsin_exoplanets-anthropic37,wisconsin_exoplanets-openai,wisconsin_exoplanets-openai10o1","2,6,5",0.9047619047619048,0.804143979441893,0.964240988134667,63,57,0.7575757575757576,0.6363888076622838,0.8546316735018541,66,50,21,29,5,13,36,21,1,3
"wisconsin_exoplanets-anthropic37,wisconsin_exoplanets-openai,wisconsin_exoplanets-openai10","2,6,5",0.9047619047619048,0.804143979441893,0.964240988134667,63,57,0.7575757575757576,0.6363888076622838,0.8546316735018541,66,50,21,29,5,13,36,21,1,3
"wisconsin_exoplanets-anthropic37,wisconsin_exoplanets-geminipro,wisconsin_exoplanets-openailong","2,2,4",0.9047619047619048,0.804143979441893,0.964240988134667,63,57,0.7272727272727273,0.6036427957562946,0.8296733838204806,66,48,21,28,5,14,36,20,1,4
"wisconsin_exoplanets-anthropic3710,wisconsin_exoplanets-gemini10,wisconsin_exoplanets-llamaphi","5,2,1",0.9047619047619048,0.804143979441893,0.964240988134667,63,57,0.8484848484848485,0.7389589287110891,0.9248753700606944,66,56,18,28,2,6,39,28,4,4
"wisconsin_exoplanets-anthropic3710,wisconsin_exoplanets-llamaphi,wisconsin_exoplanets-openai4510","5,1,2",0.9047619047619048,0.804143979441893,0.964240988134667,63,57,0.8484848484848485,0.7389589287110891,0.9248753700606944,66,56,19,29,3,7,38,27,3,3
"wisconsin_exoplanets-anthropic37,wisconsin_exoplanets-llamaphi,wisconsin_exoplanets-openailong","2,1,4",0.9047619047619048,0.804143979441893,0.964240988134667,63,57,0.7727272727272727,0.6530018980228203,0.8668572164845951,66,51,21,30,5,13,36,21,1,2
"wisconsin_exoplanets-anthropic37,wisconsin_exoplanets-llamaphi,wisconsin_exoplanets-openai4510","2,1,2",0.9047619047619048,0.804143979441893,0.964240988134667,63,57,0.7727272727272727,0.6530018980228203,0.8668572164845951,66,51,21,29,5,12,36,22,1,3
"wisconsin_exoplanets-anthropic3710,wisconsin_exoplanets-gemini10,wisconsin_exoplanets-openai","5,2,6",0.9047619047619048,0.804143979441893,0.964240988134667,63,57,0.8333333333333334,0.7213265468376222,0.9137520659512851,66,55,18,27,2,6,39,28,4,5
"wisconsin_exoplanets-anthropic37,wisconsin_exoplanets-gemini10,wisconsin_exoplanets-llamaphi","2,2,1",0.9047619047619048,0.804143979441893,0.964240988134667,63,57,0.7575757575757576,0.6363888076622838,0.8546316735018541,66,50,21,28,5,12,36,22,1,4
"wisconsin_exoplanets-anthropic37,wisconsin_exoplanets-openai4510,wisconsin_exoplanets-openailong","2,2,4",0.9047619047619048,0.804143979441893,0.964240988134667,63,57,0.7424242424242424,0.6199387593265298,0.8422336207426879,66,49,20,28,4,13,37,21,2,4
"wisconsin_exoplanets-anthropic3710,wisconsin_exoplanets-openai4510,wisconsin_exoplanets-openailong","5,2,4",0.9047619047619048,0.804143979441893,0.964240988134667,63,57,0.8333333333333334,0.7213265468376222,0.9137520659512851,66,55,19,30,3,9,38,25,3,2
"wisconsin_exoplanets-anthropic37,wisconsin_exoplanets-openai10o1,wisconsin_exoplanets-openailong","2,5,4",0.9047619047619048,0.804143979441893,0.964240988134667,63,57,0.7575757575757576,0.6363888076622838,0.8546316735018541,66,50,21,29,5,13,36,21,1,3
"wisconsin_exoplanets-anthropic,wisconsin_exoplanets-anthropic37,wisconsin_exoplanets-openai4510","2,2,2",0.9047619047619048,0.804143979441893,0.964240988134667,63,57,0.8787878787878788,0.7750598442768422,0.9461891381581342,66,58,21,28,5,4,36,30,1,4
"wisconsin_exoplanets-anthropic37,wisconsin_exoplanets-deepseek,wisconsin_exoplanets-gemini","2,1,7",0.9047619047619048,0.804143979441893,0.964240988134667,63,57,0.7575757575757576,0.6363888076622838,0.8546316735018541,66,50,19,24,3,8,38,26,3,8
"wisconsin_exoplanets-anthropic37,wisconsin_exoplanets-anthropic3710,wisconsin_exoplanets-qwq","2,5,1",0.9047619047619048,0.804143979441893,0.964240988134667,63,57,0.7878787878787878,0.6697885403521799,0.8788980677448571,66,52,19,27,3,9,38,25,3,5
"wisconsin_exoplanets-anthropic37,wisconsin_exoplanets-openaio1,wisconsin_exoplanets-phi","2,2,1",0.9047619047619048,0.804143979441893,0.964240988134667,63,57,0.7272727272727273,0.6036427957562946,0.8296733838204806,66,48,21,24,5,10,36,24,1,8
"wisconsin_exoplanets-anthropic37,wisconsin_exoplanets-anthropic3710,wisconsin_exoplanets-openai45","2,5,4",0.9047619047619048,0.804143979441893,0.964240988134667,63,57,0.7121212121212122,0.5874932401392494,0.816959774581892,66,47,22,30,6,17,35,17,0,2
"wisconsin_exoplanets-anthropic37,wisconsin_exoplanets-anthropic3710,wisconsin_exoplanets-openai10o1","2,5,5",0.9047619047619048,0.804143979441893,0.964240988134667,63,57,0.7424242424242424,0.6199387593265298,0.8422336207426879,66,49,22,31,6,16,35,18,0,1
"wisconsin_exoplanets-anthropic37,wisconsin_exoplanets-anthropic3710,wisconsin_exoplanets-geminipro","2,5,2",0.9047619047619048,0.804143979441893,0.964240988134667,63,57,0.8484848484848485,0.7389589287110891,0.9248753700606944,66,56,18,26,2,4,39,30,4,6
"wisconsin_exoplanets-anthropic,wisconsin_exoplanets-anthropic37,wisconsin_exoplanets-deepseek","2,2,1",0.9047619047619048,0.804143979441893,0.964240988134667,63,57,0.803030303030303,0.6867611541519056,0.8907397343822825,66,53,21,27,5,8,36,26,1,5
"wisconsin_exoplanets-anthropic37,wisconsin_exoplanets-anthropic3710,wisconsin_exoplanets-geminipro10","2,5,3",0.9047619047619048,0.804143979441893,0.964240988134667,63,57,0.8484848484848485,0.7389589287110891,0.9248753700606944,66,56,18,26,2,4,39,30,4,6
"wisconsin_exoplanets-anthropic3710,wisconsin_exoplanets-openai45,wisconsin_exoplanets-openailong","5,4,4",0.9047619047619048,0.804143979441893,0.964240988134667,63,57,0.8181818181818182,0.7039345441700697,0.9023647979841516,66,54,18,28,2,8,39,26,4,4
"wisconsin_exoplanets-anthropic3710,wisconsin_exoplanets-openai45,wisconsin_exoplanets-openai4510","5,4,2",0.9047619047619048,0.804143979441893,0.964240988134667,63,57,0.8484848484848485,0.7389589287110891,0.9248753700606944,66,56,19,30,3,8,38,26,3,2
"wisconsin_exoplanets-anthropic37,wisconsin_exoplanets-deepseek,wisconsin_exoplanets-openaio1","2,1,2",0.9047619047619048,0.804143979441893,0.964240988134667,63,57,0.7575757575757576,0.6363888076622838,0.8546316735018541,66,50,21,25,5,9,36,25,1,7
"wisconsin_exoplanets-openai,wisconsin_exoplanets-openai45,wisconsin_exoplanets-qwq","6,4,1",0.9,0.7818646335657977,0.9667249064109775,50,45,0.8070175438596491,0.6808902137314417,0.8995277714022677,57,46,12,22,4,4,33,24,1,7
"wisconsin_exoplanets-openai,wisconsin_exoplanets-openailong,wisconsin_exoplanets-phi","6,4,1",0.9,0.7818646335657977,0.9667249064109775,50,45,0.8245614035087719,0.7009423405431865,0.9125267711897262,57,47,12,22,4,3,33,25,1,7
"wisconsin_exoplanets-openai,wisconsin_exoplanets-openailong,wisconsin_exoplanets-qwq","6,4,1",0.9,0.7818646335657977,0.9667249064109775,50,45,0.8245614035087719,0.7009423405431865,0.9125267711897262,57,47,12,22,4,3,33,25,1,7
"wisconsin_exoplanets-openai,wisconsin_exoplanets-openai45,wisconsin_exoplanets-phi","6,4,1",0.9,0.7818646335657977,0.9667249064109775,50,45,0.8070175438596491,0.6808902137314417,0.8995277714022677,57,46,12,22,4,4,33,24,1,7
"wisconsin_exoplanets-openai,wisconsin_exoplanets-openai10o1,wisconsin_exoplanets-qwq","6,5,1",0.9,0.7818646335657977,0.9667249064109775,50,45,0.8070175438596491,0.6808902137314417,0.8995277714022677,57,46,12,21,4,3,33,25,1,8
"wisconsin_exoplanets-openai,wisconsin_exoplanets-openai10,wisconsin_exoplanets-openaio1","6,5,2",0.9,0.7818646335657977,0.9667249064109775,50,45,0.8245614035087719,0.7009423405431865,0.9125267711897262,57,47,12,22,4,3,33,25,1,7
"wisconsin_exoplanets-openai,wisconsin_exoplanets-openai10o1,wisconsin_exoplanets-phi","6,5,1",0.9,0.7818646335657977,0.9667249064109775,50,45,0.8070175438596491,0.6808902137314417,0.8995277714022677,57,46,12,21,4,3,33,25,1,8
"wisconsin_exoplanets-anthropic3710,wisconsin_exoplanets-geminipro,wisconsin_exoplanets-openai45","5,2,4",0.8888888888888888,0.784375751297472,0.9541433762831293,63,56,0.8181818181818182,0.7039345441700697,0.9023647979841516,66,54,18,28,3,8,38,26,4,4
"wisconsin_exoplanets-anthropic3710,wisconsin_exoplanets-geminipro10,wisconsin_exoplanets-openaio1","5,3,2",0.8888888888888888,0.784375751297472,0.9541433762831293,63,56,0.7424242424242424,0.6199387593265298,0.8422336207426879,66,49,16,18,1,3,40,31,6,14
"wisconsin_exoplanets-anthropic3710,wisconsin_exoplanets-gemini,wisconsin_exoplanets-openaio1","5,7,2",0.8888888888888888,0.784375751297472,0.9541433762831293,63,56,0.696969696969697,0.5714834854226349,0.8041003533935258,66,46,18,20,3,8,38,26,4,12
"wisconsin_exoplanets-anthropic3710,wisconsin_exoplanets-deepseek,wisconsin_exoplanets-gemini","5,1,7",0.8888888888888888,0.784375751297472,0.9541433762831293,63,56,0.7121212121212122,0.5874932401392494,0.816959774581892,66,47,19,21,4,8,37,26,3,11
"wisconsin_exoplanets-anthropic37,wisconsin_exoplanets-llama,wisconsin_exoplanets-openaio1","2,2,2",0.8888888888888888,0.784375751297472,0.9541433762831293,63,56,0.7121212121212122,0.5874932401392494,0.816959774581892,66,47,21,26,6,13,35,21,1,6
"wisconsin_exoplanets-anthropic37,wisconsin_exoplanets-openai10,wisconsin_exoplanets-openai4510","2,5,2",0.8888888888888888,0.784375751297472,0.9541433762831293,63,56,0.7575757575757576,0.6363888076622838,0.8546316735018541,66,50,20,29,5,13,36,21,2,3
"wisconsin_exoplanets-anthropic,wisconsin_exoplanets-gemini,wisconsin_exoplanets-openai4510","2,7,2",0.8888888888888888,0.784375751297472,0.9541433762831293,63,56,0.8181818181818182,0.7039345441700697,0.9023647979841516,66,54,17,21,2,1,39,33,5,11
"wisconsin_exoplanets-anthropic3710,wisconsin_exoplanets-gemini10,wisconsin_exoplanets-openaio1","5,2,2",0.8888888888888888,0.784375751297472,0.9541433762831293,63,56,0.7424242424242424,0.6199387593265298,0.8422336207426879,66,49,16,18,1,3,40,31,6,14
"wisconsin_exoplanets-anthropic,wisconsin_exoplanets-openaio1,wisconsin_exoplanets-phi","2,2,1",0.8888888888888888,0.784375751297472,0.9541433762831293,63,56,0.7878787878787878,0.6697885403521799,0.8788980677448571,66,52,20,23,5,5,36,29,2,9
"wisconsin_exoplanets-anthropic3710,wisconsin_exoplanets-gemini,wisconsin_exoplanets-openai4510","5,7,2",0.8888888888888888,0.784375751297472,0.9541433762831293,63,56,0.8181818181818182,0.7039345441700697,0.9023647979841516,66,54,16,24,1,4,40,30,6,8
"wisconsin_exoplanets-anthropic37,wisconsin_exoplanets-openai10,wisconsin_exoplanets-openai10o1","2,5,5",0.8888888888888888,0.784375751297472,0.9541433762831293,63,56,0.7575757575757576,0.6363888076622838,0.8546316735018541,66,50,20,29,5,13,36,21,2,3
"wisconsin_exoplanets-anthropic,wisconsin_exoplanets-gemini10,wisconsin_exoplanets-openaio1","2,2,2",0.8888888888888888,0.784375751297472,0.9541433762831293,63,56,0.7121212121212122,0.5874932401392494,0.816959774581892,66,47,17,16,2,3,39,31,5,16
"wisconsin_exoplanets-anthropic10,wisconsin_exoplanets-anthropic37,wisconsin_exoplanets-anthropic3710","1,2,5",0.8888888888888888,0.784375751297472,0.9541433762831293,63,56,0.7878787878787878,0.6697885403521799,0.8788980677448571,66,52,18,29,3,11,38,23,4,3
"wisconsin_exoplanets-anthropic37,wisconsin_exoplanets-openai10o1,wisconsin_exoplanets-openai4510","2,5,2",0.8888888888888888,0.784375751297472,0.9541433762831293,63,56,0.7575757575757576,0.6363888076622838,0.8546316735018541,66,50,20,27,5,11,36,23,2,5
"wisconsin_exoplanets-anthropic3710,wisconsin_exoplanets-geminipro,wisconsin_exoplanets-openai","5,2,6",0.8888888888888888,0.784375751297472,0.9541433762831293,63,56,0.8181818181818182,0.7039345441700697,0.9023647979841516,66,54,18,27,3,7,38,27,4,5
"wisconsin_exoplanets-anthropic37,wisconsin_exoplanets-llamaphi,wisconsin_exoplanets-openai45","2,1,4",0.8888888888888888,0.784375751297472,0.9541433762831293,63,56,0.7727272727272727,0.6530018980228203,0.8668572164845951,66,51,21,30,6,13,35,21,1,2
"wisconsin_exoplanets-anthropic37,wisconsin_exoplanets-openai,wisconsin_exoplanets-openai45","2,6,4",0.8888888888888888,0.784375751297472,0.9541433762831293,63,56,0.7575757575757576,0.6363888076622838,0.8546316735018541,66,50,21,29,6,13,35,21,1,3
"wisconsin_exoplanets-anthropic3710,wisconsin_exoplanets-geminipro,wisconsin_exoplanets-openaio1","5,2,2",0.8888888888888888,0.784375751297472,0.9541433762831293,63,56,0.7424242424242424,0.6199387593265298,0.8422336207426879,66,49,16,18,1,3,40,31,6,14
"wisconsin_exoplanets-anthropic3710,wisconsin_exoplanets-geminipro,wisconsin_exoplanets-openailong","5,2,4",0.8888888888888888,0.784375751297472,0.9541433762831293,63,56,0.803030303030303,0.6867611541519056,0.8907397343822825,66,53,18,28,3,9,38,25,4,4
"wisconsin_exoplanets-anthropic3710,wisconsin_exoplanets-gemini,wisconsin_exoplanets-llama","5,7,2",0.8888888888888888,0.784375751297472,0.9541433762831293,63,56,0.803030303030303,0.6867611541519056,0.8907397343822825,66,53,19,28,4,9,37,25,3,4
"wisconsin_exoplanets-anthropic37,wisconsin_exoplanets-openai10o1,wisconsin_exoplanets-openai45","2,5,4",0.8888888888888888,0.784375751297472,0.9541433762831293,63,56,0.7575757575757576,0.6363888076622838,0.8546316735018541,66,50,21,29,6,13,35,21,1,3
"wisconsin_exoplanets-anthropic37,wisconsin_exoplanets-openai10,wisconsin_exoplanets-openailong","2,5,4",0.8888888888888888,0.784375751297472,0.9541433762831293,63,56,0.7575757575757576,0.6363888076622838,0.8546316735018541,66,50,20,29,5,13,36,21,2,3
"wisconsin_exoplanets-anthropic37,wisconsin_exoplanets-geminipro10,wisconsin_exoplanets-llama","2,3,2",0.8888888888888888,0.784375751297472,0.9541433762831293,63,56,0.7121212121212122,0.5874932401392494,0.816959774581892,66,47,16,21,1,8,40,26,6,11
"wisconsin_exoplanets-anthropic37,wisconsin_exoplanets-anthropic3710,wisconsin_exoplanets-openai4510","2,5,2",0.8888888888888888,0.784375751297472,0.9541433762831293,63,56,0.8636363636363636,0.7568586684861609,0.9357018153567447,66,57,18,28,3,5,38,29,4,4
"wisconsin_exoplanets-anthropic3710,wisconsin_exoplanets-openaio1,wisconsin_exoplanets-phi","5,2,1",0.8888888888888888,0.784375751297472,0.9541433762831293,63,56,0.7727272727272727,0.6530018980228203,0.8668572164845951,66,51,18,24,3,7,38,27,4,8
"wisconsin_exoplanets-anthropic37,wisconsin_exoplanets-anthropic3710,wisconsin_exoplanets-phi","2,5,1",0.8888888888888888,0.784375751297472,0.9541433762831293,63,56,0.803030303030303,0.6867611541519056,0.8907397343822825,66,53,20,28,5,9,36,25,2,4
"wisconsin_exoplanets-anthropic37,wisconsin_exoplanets-anthropic3710,wisconsin_exoplanets-openailong","2,5,4",0.8888888888888888,0.784375751297472,0.9541433762831293,63,56,0.7121212121212122,0.5874932401392494,0.816959774581892,66,47,21,30,6,17,35,17,1,2
"wisconsin_exoplanets-anthropic3710,wisconsin_exoplanets-openai10,wisconsin_exoplanets-openailong","5,5,4",0.8888888888888888,0.784375751297472,0.9541433762831293,63,56,0.8181818181818182,0.7039345441700697,0.9023647979841516,66,54,18,28,3,8,38,26,4,4
"wisconsin_exoplanets-anthropic3710,wisconsin_exoplanets-openai10,wisconsin_exoplanets-openai4510","5,5,2",0.8888888888888888,0.784375751297472,0.9541433762831293,63,56,0.8333333333333334,0.7213265468376222,0.9137520659512851,66,55,19,30,4,9,37,25,3,2
"wisconsin_exoplanets-anthropic3710,wisconsin_exoplanets-openai10,wisconsin_exoplanets-openai45","5,5,4",0.8888888888888888,0.784375751297472,0.9541433762831293,63,56,0.8181818181818182,0.7039345441700697,0.9023647979841516,66,54,18,28,3,8,38,26,4,4
"wisconsin_exoplanets-anthropic37,wisconsin_exoplanets-geminipro,wisconsin_exoplanets-llamaphi","2,2,1",0.8888888888888888,0.784375751297472,0.9541433762831293,63,56,0.7272727272727273,0.6036427957562946,0.8296733838204806,66,48,21,27,6,13,35,21,1,5
"wisconsin_exoplanets-anthropic3710,wisconsin_exoplanets-openai,wisconsin_exoplanets-openailong","5,6,4",0.8888888888888888,0.784375751297472,0.9541433762831293,63,56,0.8333333333333334,0.7213265468376222,0.9137520659512851,66,55,18,29,3,8,38,26,4,3
"wisconsin_exoplanets-anthropic3710,wisconsin_exoplanets-openai10o1,wisconsin_exoplanets-openailong","5,5,4",0.8888888888888888,0.784375751297472,0.9541433762831293,63,56,0.8181818181818182,0.7039345441700697,0.9023647979841516,66,54,18,28,3,8,38,26,4,4
"wisconsin_exoplanets-anthropic3710,wisconsin_exoplanets-openai,wisconsin_exoplanets-openai45","5,6,4",0.8888888888888888,0.784375751297472,0.9541433762831293,63,56,0.8333333333333334,0.7213265468376222,0.9137520659512851,66,55,19,29,4,8,37,26,3,3
"wisconsin_exoplanets-anthropic3710,wisconsin_exoplanets-openai,wisconsin_exoplanets-openai10o1","5,6,5",0.8888888888888888,0.784375751297472,0.9541433762831293,63,56,0.8333333333333334,0.7213265468376222,0.9137520659512851,66,55,18,29,3,8,38,26,4,3
"wisconsin_exoplanets-anthropic37,wisconsin_exoplanets-anthropic3710,wisconsin_exoplanets-openai10","2,5,5",0.8888888888888888,0.784375751297472,0.9541433762831293,63,56,0.7272727272727273,0.6036427957562946,0.8296733838204806,66,48,21,31,6,17,35,17,1,1
"wisconsin_exoplanets-anthropic3710,wisconsin_exoplanets-openai,wisconsin_exoplanets-openai10","5,6,5",0.8888888888888888,0.784375751297472,0.9541433762831293,63,56,0.8484848484848485,0.7389589287110891,0.9248753700606944,66,56,18,30,3,8,38,26,4,2
"wisconsin_exoplanets-anthropic,wisconsin_exoplanets-anthropic37,wisconsin_exoplanets-phi","2,2,1",0.8888888888888888,0.784375751297472,0.9541433762831293,63,56,0.803030303030303,0.6867611541519056,0.8907397343822825,66,53,21,27,6,8,35,26,1,5
"wisconsin_exoplanets-anthropic3710,wisconsin_exoplanets-openai10o1,wisconsin_exoplanets-openai45","5,5,4",0.8888888888888888,0.784375751297472,0.9541433762831293,63,56,0.8181818181818182,0.7039345441700697,0.9023647979841516,66,54,19,28,4,8,37,26,3,4
"wisconsin_exoplanets-anthropic37,wisconsin_exoplanets-gemini10,wisconsin_exoplanets-openai10o1","2,2,5",0.8888888888888888,0.784375751297472,0.9541433762831293,63,56,0.7727272727272727,0.6530018980228203,0.8668572164845951,66,51,20,28,5,11,36,23,2,4
"wisconsin_exoplanets-anthropic37,wisconsin_exoplanets-gemini,wisconsin_exoplanets-llama","2,7,2",0.8888888888888888,0.784375751297472,0.9541433762831293,63,56,0.7121212121212122,0.5874932401392494,0.816959774581892,66,47,19,27,4,14,37,20,3,5
"wisconsin_exoplanets-anthropic37,wisconsin_exoplanets-geminipro10,wisconsin_exoplanets-openailong","2,3,4",0.8888888888888888,0.784375751297472,0.9541433762831293,63,56,0.7272727272727273,0.6036427957562946,0.8296733838204806,66,48,21,28,6,14,35,20,1,4
"wisconsin_exoplanets-anthropic37,wisconsin_exoplanets-anthropic3710,wisconsin_exoplanets-gemini10","2,5,2",0.8888888888888888,0.784375751297472,0.9541433762831293,63,56,0.8484848484848485,0.7389589287110891,0.9248753700606944,66,56,17,26,2,4,39,30,5,6
"wisconsin_exoplanets-anthropic37,wisconsin_exoplanets-anthropic3710,wisconsin_exoplanets-falcon10","2,5,1",0.8888888888888888,0.784375751297472,0.9541433762831293,63,56,0.8333333333333334,0.7213265468376222,0.9137520659512851,66,55,19,30,4,9,37,25,3,2
"wisconsin_exoplanets-anthropic3710,wisconsin_exoplanets-deepseek,wisconsin_exoplanets-openaio1","5,1,2",0.8888888888888888,0.784375751297472,0.9541433762831293,63,56,0.7575757575757576,0.6363888076622838,0.8546316735018541,66,50,21,23,6,7,35,27,1,9
"wisconsin_exoplanets-anthropic37,wisconsin_exoplanets-anthropic3710,wisconsin_exoplanets-falcon","2,5,1",0.8888888888888888,0.784375751297472,0.9541433762831293,63,56,0.7424242424242424,0.6199387593265298,0.8422336207426879,66,49,20,26,5,11,36,23,2,6
"wisconsin_exoplanets-anthropic,wisconsin_exoplanets-anthropic3710,wisconsin_exoplanets-llama","2,5,2",0.8888888888888888,0.784375751297472,0.9541433762831293,63,56,0.8333333333333334,0.7213265468376222,0.9137520659512851,66,55,20,27,5,6,36,28,2,5
"wisconsin_exoplanets-anthropic37,wisconsin_exoplanets-anthropic3710,wisconsin_exoplanets-gemma","2,5,1",0.8888888888888888,0.784375751297472,0.9541433762831293,63,56,0.8181818181818182,0.7039345441700697,0.9023647979841516,66,54,19,29,4,9,37,25,3,3
"wisconsin_exoplanets-openailong,wisconsin_exoplanets-phi,wisconsin_exoplanets-qwq","4,1,1",0.8867924528301887,0.7697100836291368,0.9573036050637264,53,47,0.8714285714285714,0.7699116098309631,0.9394866858096107,70,61,16,19,0,4,31,42,6,5
"wisconsin_exoplanets-openailong,wisconsin_exoplanets-openaio1,wisconsin_exoplanets-qwq","4,2,1",0.8867924528301887,0.7697100836291368,0.9573036050637264,53,47,0.8714285714285714,0.7699116098309631,0.9394866858096107,70,61,16,19,0,4,31,42,6,5
"wisconsin_exoplanets-openailong,wisconsin_exoplanets-openaio1,wisconsin_exoplanets-phi","4,2,1",0.8867924528301887,0.7697100836291368,0.9573036050637264,53,47,0.8714285714285714,0.7699116098309631,0.9394866858096107,70,61,16,19,0,4,31,42,6,5
"wisconsin_exoplanets-openai10,wisconsin_exoplanets-openailong,wisconsin_exoplanets-qwq","5,4,1",0.8867924528301887,0.7697100836291368,0.9573036050637264,53,47,0.8714285714285714,0.7699116098309631,0.9394866858096107,70,61,18,21,2,6,29,40,4,3
"wisconsin_exoplanets-openai10,wisconsin_exoplanets-openai45,wisconsin_exoplanets-openailong","5,4,4",0.8867924528301887,0.7697100836291368,0.9573036050637264,53,47,0.8857142857142857,0.7871719578309098,0.9493478012096436,70,62,16,19,0,3,31,43,6,5
"wisconsin_exoplanets-openai,wisconsin_exoplanets-openai10,wisconsin_exoplanets-qwq","6,5,1",0.88,0.7568986832944374,0.9546646792263361,50,44,0.8245614035087719,0.7009423405431865,0.9125267711897262,57,47,12,22,5,3,32,25,1,7
"wisconsin_exoplanets-openai,wisconsin_exoplanets-openai10,wisconsin_exoplanets-phi","6,5,1",0.88,0.7568986832944374,0.9546646792263361,50,44,0.8245614035087719,0.7009423405431865,0.9125267711897262,57,47,12,22,5,3,32,25,1,7
"wisconsin_exoplanets-anthropic37,wisconsin_exoplanets-gemini,wisconsin_exoplanets-gemini10","2,7,2",0.873015873015873,0.7650344243043459,0.943548720454697,63,55,0.7121212121212122,0.5874932401392494,0.816959774581892,66,47,14,17,0,4,41,30,8,15
"wisconsin_exoplanets-anthropic37,wisconsin_exoplanets-gemini,wisconsin_exoplanets-geminipro","2,7,2",0.873015873015873,0.7650344243043459,0.943548720454697,63,55,0.6515151515151515,0.5242397683271001,0.7647080305896783,66,43,15,14,1,5,40,29,7,18
"wisconsin_exoplanets-anthropic3710,wisconsin_exoplanets-gemini,wisconsin_exoplanets-gemma","5,7,1",0.873015873015873,0.7650344243043459,0.943548720454697,63,55,0.696969696969697,0.5714834854226349,0.8041003533935258,66,46,18,20,4,8,37,26,4,12
"wisconsin_exoplanets-anthropic37,wisconsin_exoplanets-gemma,wisconsin_exoplanets-openaio1","2,1,2",0.873015873015873,0.7650344243043459,0.943548720454697,63,55,0.696969696969697,0.5714834854226349,0.8041003533935258,66,46,21,22,7,10,34,24,1,10
"wisconsin_exoplanets-anthropic,wisconsin_exoplanets-anthropic37,wisconsin_exoplanets-openaio1","2,2,2",0.873015873015873,0.7650344243043459,0.943548720454697,63,55,0.8333333333333334,0.7213265468376222,0.9137520659512851,66,55,20,26,6,5,35,29,2,6
"wisconsin_exoplanets-anthropic37,wisconsin_exoplanets-deepseek,wisconsin_exoplanets-gemini10","2,1,2",0.873015873015873,0.7650344243043459,0.943548720454697,63,55,0.7575757575757576,0.6363888076622838,0.8546316735018541,66,50,16,21,2,5,39,29,6,11
"wisconsin_exoplanets-anthropic,wisconsin_exoplanets-anthropic37,wisconsin_exoplanets-gemma","2,2,1",0.873015873015873,0.7650344243043459,0.943548720454697,63,55,0.8181818181818182,0.7039345441700697,0.9023647979841516,66,54,20,28,6,8,35,26,2,4
"wisconsin_exoplanets-anthropic,wisconsin_exoplanets-llama,wisconsin_exoplanets-openaio1","2,2,2",0.873015873015873,0.7650344243043459,0.943548720454697,63,55,0.7575757575757576,0.6363888076622838,0.8546316735018541,66,50,20,25,6,9,35,25,2,7
"wisconsin_exoplanets-anthropic37,wisconsin_exoplanets-gemini10,wisconsin_exoplanets-llama","2,2,2",0.873015873015873,0.7650344243043459,0.943548720454697,63,55,0.7272727272727273,0.6036427957562946,0.8296733838204806,66,48,15,22,1,8,40,26,7,10
"wisconsin_exoplanets-anthropic,wisconsin_exoplanets-anthropic37,wisconsin_exoplanets-falcon10","2,2,1",0.873015873015873,0.7650344243043459,0.943548720454697,63,55,0.7727272727272727,0.6530018980228203,0.8668572164845951,66,51,20,28,6,11,35,23,2,4
"wisconsin_exoplanets-deepseek,wisconsin_exoplanets-gemini,wisconsin_exoplanets-openai4510","1,7,2",0.873015873015873,0.7650344243043459,0.943548720454697,63,55,0.7121212121212122,0.5874932401392494,0.816959774581892,66,47,15,18,1,5,40,29,7,14
"wisconsin_exoplanets-gemini,wisconsin_exoplanets-openai4510,wisconsin_exoplanets-openaio1","7,2,2",0.873015873015873,0.7650344243043459,0.943548720454697,63,55,0.7121212121212122,0.5874932401392494,0.816959774581892,66,47,17,16,3,3,38,31,5,16
"wisconsin_exoplanets-anthropic,wisconsin_exoplanets-openai45,wisconsin_exoplanets-openai4510","2,4,2",0.873015873015873,0.7650344243043459,0.943548720454697,63,55,0.8636363636363636,0.7568586684861609,0.9357018153567447,66,57,22,28,8,5,33,29,0,4
"wisconsin_exoplanets-gemini10,wisconsin_exoplanets-llamaphi,wisconsin_exoplanets-openaio1","2,1,2",0.873015873015873,0.7650344243043459,0.943548720454697,63,55,0.6818181818181818,0.5556078292305275,0.7911016327585585,66,45,19,18,5,7,36,27,3,14
"wisconsin_exoplanets-anthropic,wisconsin_exoplanets-geminipro10,wisconsin_exoplanets-openaio1","2,3,2",0.873015873015873,0.7650344243043459,0.943548720454697,63,55,0.7121212121212122,0.5874932401392494,0.816959774581892,66,47,17,16,3,3,38,31,5,16
"wisconsin_exoplanets-anthropic37,wisconsin_exoplanets-gemini10,wisconsin_exoplanets-openai10","2,2,5",0.873015873015873,0.7650344243043459,0.943548720454697,63,55,0.7575757575757576,0.6363888076622838,0.8546316735018541,66,50,19,29,5,13,36,21,3,3
"wisconsin_exoplanets-anthropic,wisconsin_exoplanets-anthropic3710,wisconsin_exoplanets-openaio1","2,5,2",0.873015873015873,0.7650344243043459,0.943548720454697,63,55,0.803030303030303,0.6867611541519056,0.8907397343822825,66,53,19,26,5,7,36,27,3,6
"wisconsin_exoplanets-anthropic3710,wisconsin_exoplanets-llamaphi,wisconsin_exoplanets-openai10o1","5,1,5",0.873015873015873,0.7650344243043459,0.943548720454697,63,55,0.803030303030303,0.6867611541519056,0.8907397343822825,66,53,18,29,4,10,37,24,4,3
"wisconsin_exoplanets-anthropic,wisconsin_exoplanets-anthropic3710,wisconsin_exoplanets-phi","2,5,1",0.873015873015873,0.7650344243043459,0.943548720454697,63,55,0.8484848484848485,0.7389589287110891,0.9248753700606944,66,56,19,27,5,5,36,29,3,5
"wisconsin_exoplanets-anthropic3710,wisconsin_exoplanets-geminipro,wisconsin_exoplanets-llamaphi","5,2,1",0.873015873015873,0.7650344243043459,0.943548720454697,63,55,0.8181818181818182,0.7039345441700697,0.9023647979841516,66,54,17,27,3,7,38,27,5,5
"wisconsin_exoplanets-anthropic37,wisconsin_exoplanets-geminipro,wisconsin_exoplanets-openai10","2,2,5",0.873015873015873,0.7650344243043459,0.943548720454697,63,55,0.7424242424242424,0.6199387593265298,0.8422336207426879,66,49,20,29,6,14,35,20,2,3
"wisconsin_exoplanets-anthropic37,wisconsin_exoplanets-geminipro,wisconsin_exoplanets-openai10o1","2,2,5",0.873015873015873,0.7650344243043459,0.943548720454697,63,55,0.7575757575757576,0.6363888076622838,0.8546316735018541,66,50,20,28,6,12,35,22,2,4
"wisconsin_exoplanets-anthropic3710,wisconsin_exoplanets-llamaphi,wisconsin_exoplanets-openailong","5,1,4",0.873015873015873,0.7650344243043459,0.943548720454697,63,55,0.803030303030303,0.6867611541519056,0.8907397343822825,66,53,18,29,4,10,37,24,4,3
"wisconsin_exoplanets-anthropic3710,wisconsin_exoplanets-llamaphi,wisconsin_exoplanets-openai45","5,1,4",0.873015873015873,0.7650344243043459,0.943548720454697,63,55,0.803030303030303,0.6867611541519056,0.8907397343822825,66,53,19,29,5,10,36,24,3,3
"wisconsin_exoplanets-anthropic3710,wisconsin_exoplanets-llamaphi,wisconsin_exoplanets-openai10","5,1,5",0.873015873015873,0.7650344243043459,0.943548720454697,63,55,0.8181818181818182,0.7039345441700697,0.9023647979841516,66,54,18,30,4,10,37,24,4,2
"wisconsin_exoplanets-anthropic3710,wisconsin_exoplanets-gemini10,wisconsin_exoplanets-openai10o1","5,2,5",0.873015873015873,0.7650344243043459,0.943548720454697,63,55,0.8181818181818182,0.7039345441700697,0.9023647979841516,66,54,17,27,3,7,38,27,5,5
"wisconsin_exoplanets-anthropic37,wisconsin_exoplanets-geminipro10,wisconsin_exoplanets-llamaphi","2,3,1",0.873015873015873,0.7650344243043459,0.943548720454697,63,55,0.7272727272727273,0.6036427957562946,0.8296733838204806,66,48,21,27,7,13,34,21,1,5
"wisconsin_exoplanets-anthropic3710,wisconsin_exoplanets-geminipro10,wisconsin_exoplanets-openai","5,3,6",0.873015873015873,0.7650344243043459,0.943548720454697,63,55,0.8181818181818182,0.7039345441700697,0.9023647979841516,66,54,18,27,4,7,37,27,4,5
"wisconsin_exoplanets-anthropic37,wisconsin_exoplanets-geminipro10,wisconsin_exoplanets-openai10o1","2,3,5",0.873015873015873,0.7650344243043459,0.943548720454697,63,55,0.7575757575757576,0.6363888076622838,0.8546316735018541,66,50,21,28,7,12,34,22,1,4
"wisconsin_exoplanets-anthropic3710,wisconsin_exoplanets-geminipro10,wisconsin_exoplanets-openai45","5,3,4",0.873015873015873,0.7650344243043459,0.943548720454697,63,55,0.8181818181818182,0.7039345441700697,0.9023647979841516,66,54,18,28,4,8,37,26,4,4
"wisconsin_exoplanets-anthropic3710,wisconsin_exoplanets-gemma,wisconsin_exoplanets-openai4510","5,1,2",0.873015873015873,0.7650344243043459,0.943548720454697,63,55,0.696969696969697,0.5714834854226349,0.8041003533935258,66,46,14,16,0,4,41,30,8,16
"wisconsin_exoplanets-anthropic3710,wisconsin_exoplanets-geminipro10,wisconsin_exoplanets-openailong","5,3,4",0.873015873015873,0.7650344243043459,0.943548720454697,63,55,0.803030303030303,0.6867611541519056,0.8907397343822825,66,53,18,28,4,9,37,25,4,4
"wisconsin_exoplanets-anthropic,wisconsin_exoplanets-deepseek,wisconsin_exoplanets-openaio1","2,1,2",0.873015873015873,0.7650344243043459,0.943548720454697,63,55,0.8181818181818182,0.7039345441700697,0.9023647979841516,66,54,20,24,6,4,35,30,2,8
"wisconsin_exoplanets-anthropic3710,wisconsin_exoplanets-openai10,wisconsin_exoplanets-openai10o1","5,5,5",0.873015873015873,0.7650344243043459,0.943548720454697,63,55,0.8333333333333334,0.7213265468376222,0.9137520659512851,66,55,17,29,3,8,38,26,5,3
"wisconsin_exoplanets-anthropic3710,wisconsin_exoplanets-openai10o1,wisconsin_exoplanets-openaio1","5,5,2",0.873015873015873,0.7650344243043459,0.943548720454697,63,55,0.7727272727272727,0.6530018980228203,0.8668572164845951,66,51,21,28,7,11,34,23,1,4
"wisconsin_exoplanets-anthropic,wisconsin_exoplanets-geminipro,wisconsin_exoplanets-openaio1","2,2,2",0.873015873015873,0.7650344243043459,0.943548720454697,63,55,0.7121212121212122,0.5874932401392494,0.816959774581892,66,47,17,16,3,3,38,31,5,16
"wisconsin_exoplanets-anthropic37,wisconsin_exoplanets-gemma,wisconsin_exoplanets-openai4510","2,1,2",0.873015873015873,0.7650344243043459,0.943548720454697,63,55,0.6818181818181818,0.5556078292305275,0.7911016327585585,66,45,17,17,3,6,38,28,5,15
"wisconsin_exoplanets-anthropic3710,wisconsin_exoplanets-gemini,wisconsin_exoplanets-phi","5,7,1",0.873015873015873,0.7650344243043459,0.943548720454697,63,55,0.7424242424242424,0.6199387593265298,0.8422336207426879,66,49,16,22,2,7,39,27,6,10
"wisconsin_exoplanets-anthropic3710,wisconsin_exoplanets-openai45,wisconsin_exoplanets-openaio1","5,4,2",0.873015873015873,0.7650344243043459,0.943548720454697,63,55,0.7727272727272727,0.6530018980228203,0.8668572164845951,66,51,21,28,7,11,34,23,1,4
"wisconsin_exoplanets-anthropic3710,wisconsin_exoplanets-openai10o1,wisconsin_exoplanets-openai4510","5,5,2",0.873015873015873,0.7650344243043459,0.943548720454697,63,55,0.8181818181818182,0.7039345441700697,0.9023647979841516,66,54,18,28,4,8,37,26,4,4
"wisconsin_exoplanets-gemini10,wisconsin_exoplanets-openai,wisconsin_exoplanets-openaio1","2,6,2",0.873015873015873,0.7650344243043459,0.943548720454697,63,55,0.6818181818181818,0.5556078292305275,0.7911016327585585,66,45,19,17,5,6,36,28,3,15
"wisconsin_exoplanets-anthropic10,wisconsin_exoplanets-anthropic37,wisconsin_exoplanets-openaio1","1,2,2",0.873015873015873,0.7650344243043459,0.943548720454697,63,55,0.6515151515151515,0.5242397683271001,0.7647080305896783,66,43,19,21,5,12,36,22,3,11
"wisconsin_exoplanets-anthropic3710,wisconsin_exoplanets-gemini10,wisconsin_exoplanets-openai10","5,2,5",0.873015873015873,0.7650344243043459,0.943548720454697,63,55,0.8181818181818182,0.7039345441700697,0.9023647979841516,66,54,17,28,3,8,38,26,5,4
"wisconsin_exoplanets-openai10,wisconsin_exoplanets-openaio1,wisconsin_exoplanets-phi","5,2,1",0.8679245283018868,0.7466317671362636,0.9452098981468189,53,46,0.8285714285714286,0.7196915890949332,0.9081577925723143,70,58,16,18,1,6,30,40,6,6
"wisconsin_exoplanets-openai10,wisconsin_exoplanets-openai10o1,wisconsin_exoplanets-openailong","5,5,4",0.8679245283018868,0.7466317671362636,0.9452098981468189,53,46,0.8857142857142857,0.7871719578309098,0.9493478012096436,70,62,17,22,2,6,29,40,5,2
"wisconsin_exoplanets-gemini,wisconsin_exoplanets-openai,wisconsin_exoplanets-openai4510","7,6,2",0.8571428571428571,0.7460585493565118,0.9325368444285195,63,54,0.7424242424242424,0.6199387593265298,0.8422336207426879,66,49,20,24,7,9,34,25,2,8
"wisconsin_exoplanets-anthropic10,wisconsin_exoplanets-anthropic3710,wisconsin_exoplanets-openai4510","1,5,2",0.8571428571428571,0.7460585493565118,0.9325368444285195,63,54,0.803030303030303,0.6867611541519056,0.8907397343822825,66,53,14,23,1,4,40,30,8,9
"wisconsin_exoplanets-anthropic37,wisconsin_exoplanets-gemini,wisconsin_exoplanets-phi","2,7,1",0.8571428571428571,0.7460585493565118,0.9325368444285195,63,54,0.6818181818181818,0.5556078292305275,0.7911016327585585,66,45,17,21,4,10,37,24,5,11
"wisconsin_exoplanets-anthropic37,wisconsin_exoplanets-gemini,wisconsin_exoplanets-gemma","2,7,1",0.8571428571428571,0.7460585493565118,0.9325368444285195,63,54,0.6515151515151515,0.5242397683271001,0.7647080305896783,66,43,18,20,5,11,36,23,4,12
"wisconsin_exoplanets-gemini10,wisconsin_exoplanets-openai10o1,wisconsin_exoplanets-openaio1","2,5,2",0.8571428571428571,0.7460585493565118,0.9325368444285195,63,54,0.6666666666666666,0.5398613431497497,0.7779692372780057,66,44,18,17,5,7,36,27,4,15
"wisconsin_exoplanets-gemini10,wisconsin_exoplanets-openai45,wisconsin_exoplanets-openaio1","2,4,2",0.8571428571428571,0.7460585493565118,0.9325368444285195,63,54,0.6818181818181818,0.5556078292305275,0.7911016327585585,66,45,19,18,6,7,35,27,3,14
"wisconsin_exoplanets-anthropic37,wisconsin_exoplanets-geminipro10,wisconsin_exoplanets-openai10","2,3,5",0.8571428571428571,0.7460585493565118,0.9325368444285195,63,54,0.7424242424242424,0.6199387593265298,0.8422336207426879,66,49,20,29,7,14,34,20,2,3
"wisconsin_exoplanets-anthropic37,wisconsin_exoplanets-falcon10,wisconsin_exoplanets-openaio1","2,1,2",0.8571428571428571,0.7460585493565118,0.9325368444285195,63,54,0.7272727272727273,0.6036427957562946,0.8296733838204806,66,48,20,26,7,12,34,22,2,6
"wisconsin_exoplanets-anthropic37,wisconsin_exoplanets-gemini,wisconsin_exoplanets-geminipro10","2,7,3",0.8571428571428571,0.7460585493565118,0.9325368444285195,63,54,0.6666666666666666,0.5398613431497497,0.7779692372780057,66,44,15,15,2,5,39,29,7,17
"wisconsin_exoplanets-anthropic37,wisconsin_exoplanets-openai,wisconsin_exoplanets-openaio1","2,6,2",0.8571428571428571,0.7460585493565118,0.9325368444285195,63,54,0.7272727272727273,0.6036427957562946,0.8296733838204806,66,48,22,29,9,15,32,19,0,3
"wisconsin_exoplanets-anthropic37,wisconsin_exoplanets-geminipro,wisconsin_exoplanets-llama","2,2,2",0.8571428571428571,0.7460585493565118,0.9325368444285195,63,54,0.696969696969697,0.5714834854226349,0.8041003533935258,66,46,15,20,2,8,39,26,7,12
"wisconsin_exoplanets-anthropic,wisconsin_exoplanets-openai4510,wisconsin_exoplanets-openailong","2,2,4",0.8571428571428571,0.7460585493565118,0.9325368444285195,63,54,0.8484848484848485,0.7389589287110891,0.9248753700606944,66,56,21,28,8,6,33,28,1,4
"wisconsin_exoplanets-geminipro,wisconsin_exoplanets-openai,wisconsin_exoplanets-openaio1","2,6,2",0.8571428571428571,0.7460585493565118,0.9325368444285195,63,54,0.6666666666666666,0.5398613431497497,0.7779692372780057,66,44,19,17,6,7,35,27,3,15
"wisconsin_exoplanets-anthropic37,wisconsin_exoplanets-deepseek,wisconsin_exoplanets-geminipro10","2,1,3",0.8571428571428571,0.7460585493565118,0.9325368444285195,63,54,0.7424242424242424,0.6199387593265298,0.8422336207426879,66,49,15,21,2,6,39,28,7,11
"wisconsin_exoplanets-anthropic,wisconsin_exoplanets-anthropic10,wisconsin_exoplanets-anthropic37","2,1,2",0.8571428571428571,0.7460585493565118,0.9325368444285195,63,54,0.7878787878787878,0.6697885403521799,0.8788980677448571,66,52,20,27,7,9,34,25,2,5
"wisconsin_exoplanets-anthropic,wisconsin_exoplanets-anthropic3710,wisconsin_exoplanets-llamaphi","2,5,1",0.8571428571428571,0.7460585493565118,0.9325368444285195,63,54,0.8333333333333334,0.7213265468376222,0.9137520659512851,66,55,22,29,9,8,32,26,0,3
"wisconsin_exoplanets-anthropic,wisconsin_exoplanets-anthropic3710,wisconsin_exoplanets-gemma","2,5,1",0.8571428571428571,0.7460585493565118,0.9325368444285195,63,54,0.8484848484848485,0.7389589287110891,0.9248753700606944,66,56,19,27,6,5,35,29,3,5
"wisconsin_exoplanets-anthropic,wisconsin_exoplanets-anthropic37,wisconsin_exoplanets-openai","2,2,6",0.8571428571428571,0.7460585493565118,0.9325368444285195,63,54,0.7727272727272727,0.6530018980228203,0.8668572164845951,66,51,22,29,9,12,32,22,0,3
"wisconsin_exoplanets-anthropic,wisconsin_exoplanets-llama,wisconsin_exoplanets-openai4510","2,2,2",0.8571428571428571,0.7460585493565118,0.9325368444285195,63,54,0.7727272727272727,0.6530018980228203,0.8668572164845951,66,51,17,20,4,3,37,31,5,12
"wisconsin_exoplanets-anthropic,wisconsin_exoplanets-anthropic37,wisconsin_exoplanets-llama","2,2,2",0.8571428571428571,0.7460585493565118,0.9325368444285195,63,54,0.7575757575757576,0.6363888076622838,0.8546316735018541,66,50,21,27,8,11,33,23,1,5
"wisconsin_exoplanets-anthropic,wisconsin_exoplanets-anthropic3710,wisconsin_exoplanets-openai","2,5,6",0.8571428571428571,0.7460585493565118,0.9325368444285195,63,54,0.8181818181818182,0.7039345441700697,0.9023647979841516,66,54,22,28,9,8,32,26,0,4
"wisconsin_exoplanets-anthropic,wisconsin_exoplanets-anthropic37,wisconsin_exoplanets-geminipro10","2,2,3",0.8571428571428571,0.7460585493565118,0.9325368444285195,63,54,0.8636363636363636,0.7568586684861609,0.9357018153567447,66,57,18,26,5,3,36,31,4,6
"wisconsin_exoplanets-anthropic3710,wisconsin_exoplanets-llama,wisconsin_exoplanets-openaio1","5,2,2",0.8571428571428571,0.7460585493565118,0.9325368444285195,63,54,0.7878787878787878,0.6697885403521799,0.8788980677448571,66,52,19,26,6,8,35,26,3,6
"wisconsin_exoplanets-openai4510,wisconsin_exoplanets-openailong,wisconsin_exoplanets-openaio1","2,4,2",0.8571428571428571,0.7460585493565118,0.9325368444285195,63,54,0.8181818181818182,0.7039345441700697,0.9023647979841516,66,54,20,28,7,8,34,26,2,4
"wisconsin_exoplanets-anthropic,wisconsin_exoplanets-anthropic3710,wisconsin_exoplanets-openai45","2,5,4",0.8571428571428571,0.7460585493565118,0.9325368444285195,63,54,0.8181818181818182,0.7039345441700697,0.9023647979841516,66,54,22,30,9,10,32,24,0,2
"wisconsin_exoplanets-anthropic3710,wisconsin_exoplanets-geminipro,wisconsin_exoplanets-gemma","5,2,1",0.8571428571428571,0.7460585493565118,0.9325368444285195,63,54,0.5909090909090909,0.46293656355858825,0.7104508976039902,66,39,13,9,0,4,41,30,9,23
"wisconsin_exoplanets-anthropic3710,wisconsin_exoplanets-geminipro10,wisconsin_exoplanets-openai4510","5,3,2",0.8571428571428571,0.7460585493565118,0.9325368444285195,63,54,0.7575757575757576,0.6363888076622838,0.8546316735018541,66,50,13,16,0,0,41,34,9,16
"wisconsin_exoplanets-anthropic,wisconsin_exoplanets-anthropic37,wisconsin_exoplanets-geminipro","2,2,2",0.8571428571428571,0.7460585493565118,0.9325368444285195,63,54,0.8636363636363636,0.7568586684861609,0.9357018153567447,66,57,18,26,5,3,36,31,4,6
"wisconsin_exoplanets-anthropic,wisconsin_exoplanets-anthropic37,wisconsin_exoplanets-gemini10","2,2,2",0.8571428571428571,0.7460585493565118,0.9325368444285195,63,54,0.8636363636363636,0.7568586684861609,0.9357018153567447,66,57,17,26,4,3,37,31,5,6
"wisconsin_exoplanets-anthropic3710,wisconsin_exoplanets-openailong,wisconsin_exoplanets-openaio1","5,4,2",0.8571428571428571,0.7460585493565118,0.9325368444285195,63,54,0.7575757575757576,0.6363888076622838,0.8546316735018541,66,50,20,28,7,12,34,22,2,4
"wisconsin_exoplanets-anthropic3710,wisconsin_exoplanets-gemini10,wisconsin_exoplanets-llama","5,2,2",0.8571428571428571,0.7460585493565118,0.9325368444285195,63,54,0.7727272727272727,0.6530018980228203,0.8668572164845951,66,51,13,22,0,5,41,29,9,10
"wisconsin_exoplanets-anthropic3710,wisconsin_exoplanets-llamaphi,wisconsin_exoplanets-openaio1","5,1,2",0.8571428571428571,0.7460585493565118,0.9325368444285195,63,54,0.7575757575757576,0.6363888076622838,0.8546316735018541,66,50,21,28,8,12,33,22,1,4
"wisconsin_exoplanets-anthropic3710,wisconsin_exoplanets-openai,wisconsin_exoplanets-openaio1","5,6,2",0.8571428571428571,0.7460585493565118,0.9325368444285195,63,54,0.7727272727272727,0.6530018980228203,0.8668572164845951,66,51,21,28,8,11,33,23,1,4
"wisconsin_exoplanets-anthropic,wisconsin_exoplanets-anthropic37,wisconsin_exoplanets-gemini","2,2,7",0.8571428571428571,0.7460585493565118,0.9325368444285195,63,54,0.7878787878787878,0.6697885403521799,0.8788980677448571,66,52,19,26,6,8,35,26,3,6
"wisconsin_exoplanets-anthropic3710,wisconsin_exoplanets-geminipro,wisconsin_exoplanets-openai10","5,2,5",0.8571428571428571,0.7460585493565118,0.9325368444285195,63,54,0.803030303030303,0.6867611541519056,0.8907397343822825,66,53,17,28,4,9,37,25,5,4
"wisconsin_exoplanets-anthropic,wisconsin_exoplanets-anthropic3710,wisconsin_exoplanets-falcon10","2,5,1",0.8571428571428571,0.7460585493565118,0.9325368444285195,63,54,0.8484848484848485,0.7389589287110891,0.9248753700606944,66,56,19,28,6,6,35,28,3,4
"wisconsin_exoplanets-anthropic,wisconsin_exoplanets-anthropic37,wisconsin_exoplanets-openailong","2,2,4",0.8571428571428571,0.7460585493565118,0.9325368444285195,63,54,0.7121212121212122,0.5874932401392494,0.816959774581892,66,47,22,28,9,15,32,19,0,4
"wisconsin_exoplanets-anthropic,wisconsin_exoplanets-anthropic37,wisconsin_exoplanets-openai45","2,2,4",0.8571428571428571,0.7460585493565118,0.9325368444285195,63,54,0.7121212121212122,0.5874932401392494,0.816959774581892,66,47,22,28,9,15,32,19,0,4
"wisconsin_exoplanets-anthropic3710,wisconsin_exoplanets-geminipro10,wisconsin_exoplanets-llamaphi","5,3,1",0.8571428571428571,0.7460585493565118,0.9325368444285195,63,54,0.8181818181818182,0.7039345441700697,0.9023647979841516,66,54,17,27,4,7,37,27,5,5
"wisconsin_exoplanets-anthropic3710,wisconsin_exoplanets-geminipro10,wisconsin_exoplanets-llama","5,3,2",0.8571428571428571,0.7460585493565118,0.9325368444285195,63,54,0.7575757575757576,0.6363888076622838,0.8546316735018541,66,50,13,21,0,5,41,29,9,11
"wisconsin_exoplanets-anthropic3710,wisconsin_exoplanets-geminipro10,wisconsin_exoplanets-gemma","5,3,1",0.8571428571428571,0.7460585493565118,0.9325368444285195,63,54,0.6363636363636364,0.5087394315103153,0.7513222169426668,66,42,13,12,0,4,41,30,9,20
"wisconsin_exoplanets-anthropic,wisconsin_exoplanets-anthropic3710,wisconsin_exoplanets-gemini","2,5,7",0.8571428571428571,0.7460585493565118,0.9325368444285195,63,54,0.8333333333333334,0.7213265468376222,0.9137520659512851,66,55,18,27,5,6,36,28,4,5
"wisconsin_exoplanets-anthropic,wisconsin_exoplanets-openai,wisconsin_exoplanets-openai4510","2,6,2",0.8571428571428571,0.7460585493565118,0.9325368444285195,63,54,0.8484848484848485,0.7389589287110891,0.9248753700606944,66,56,22,28,9,6,32,28,0,4
"wisconsin_exoplanets-anthropic3710,wisconsin_exoplanets-falcon10,wisconsin_exoplanets-gemini","5,1,7",0.8571428571428571,0.7460585493565118,0.9325368444285195,63,54,0.7727272727272727,0.6530018980228203,0.8668572164845951,66,51,18,24,5,7,36,27,4,8
"wisconsin_exoplanets-anthropic3710,wisconsin_exoplanets-gemma,wisconsin_exoplanets-openaio1","5,1,2",0.8571428571428571,0.7460585493565118,0.9325368444285195,63,54,0.7272727272727273,0.6036427957562946,0.8296733838204806,66,48,19,21,6,7,35,27,3,11
"wisconsin_exoplanets-anthropic3710,wisconsin_exoplanets-llama,wisconsin_exoplanets-openai4510","5,2,2",0.8571428571428571,0.7460585493565118,0.9325368444285195,63,54,0.7424242424242424,0.6199387593265298,0.8422336207426879,66,49,14,21,1,6,40,28,8,11
"wisconsin_exoplanets-openai10,wisconsin_exoplanets-openai4510,wisconsin_exoplanets-openaio1","5,2,2",0.8490566037735849,0.7240788211452831,0.9325074618840362,53,45,0.8714285714285714,0.7699116098309631,0.9394866858096107,70,61,15,19,1,4,30,42,7,5
"wisconsin_exoplanets-openai10,wisconsin_exoplanets-openai4510,wisconsin_exoplanets-phi","5,2,1",0.8490566037735849,0.7240788211452831,0.9325074618840362,53,45,0.8571428571428571,0.7529317522496477,0.9293095457331302,70,60,15,19,1,5,30,41,7,5
"wisconsin_exoplanets-openai10,wisconsin_exoplanets-openaio1,wisconsin_exoplanets-qwq","5,2,1",0.8490566037735849,0.7240788211452831,0.9325074618840362,53,45,0.8285714285714286,0.7196915890949332,0.9081577925723143,70,58,16,18,2,6,29,40,6,6
"wisconsin_exoplanets-openai10,wisconsin_exoplanets-phi,wisconsin_exoplanets-qwq","5,1,1",0.8490566037735849,0.7240788211452831,0.9325074618840362,53,45,0.8285714285714286,0.7196915890949332,0.9081577925723143,70,58,16,18,2,6,29,40,6,6
"wisconsin_exoplanets-anthropic37,wisconsin_exoplanets-geminipro10,wisconsin_exoplanets-openai4510","2,3,2",0.8412698412698413,0.7274019825071563,0.9211661892477585,63,53,0.7727272727272727,0.6530018980228203,0.8668572164845951,66,51,13,18,1,1,40,33,9,14
"wisconsin_exoplanets-geminipro10,wisconsin_exoplanets-openai4510,wisconsin_exoplanets-openaio1","3,2,2",0.8412698412698413,0.7274019825071563,0.9211661892477585,63,53,0.6363636363636364,0.5087394315103153,0.7513222169426668,66,42,12,8,0,0,41,34,10,24
"wisconsin_exoplanets-anthropic,wisconsin_exoplanets-gemini,wisconsin_exoplanets-gemini10","2,7,2",0.8412698412698413,0.7274019825071563,0.9211661892477585,63,53,0.7575757575757576,0.6363888076622838,0.8546316735018541,66,50,14,17,2,1,39,33,8,15
"wisconsin_exoplanets-anthropic37,wisconsin_exoplanets-geminipro10,wisconsin_exoplanets-gemma","2,3,1",0.8412698412698413,0.7274019825071563,0.9211661892477585,63,53,0.6363636363636364,0.5087394315103153,0.7513222169426668,66,42,14,15,2,7,39,27,8,17
"wisconsin_exoplanets-anthropic3710,wisconsin_exoplanets-openaio1,wisconsin_exoplanets-qwq","5,2,1",0.8412698412698413,0.7274019825071563,0.9211661892477585,63,53,0.696969696969697,0.5714834854226349,0.8041003533935258,66,46,18,20,6,8,35,26,4,12
"wisconsin_exoplanets-anthropic,wisconsin_exoplanets-anthropic3710,wisconsin_exoplanets-qwq","2,5,1",0.8412698412698413,0.7274019825071563,0.9211661892477585,63,53,0.8484848484848485,0.7389589287110891,0.9248753700606944,66,56,18,25,6,3,35,31,4,7
"wisconsin_exoplanets-anthropic37,wisconsin_exoplanets-geminipro,wisconsin_exoplanets-gemma","2,2,1",0.8412698412698413,0.7274019825071563,0.9211661892477585,63,53,0.5909090909090909,0.46293656355858825,0.7104508976039902,66,39,14,12,2,7,39,27,8,20
"wisconsin_exoplanets-geminipro10,wisconsin_exoplanets-openai,wisconsin_exoplanets-openaio1","3,6,2",0.8412698412698413,0.7274019825071563,0.9211661892477585,63,53,0.6666666666666666,0.5398613431497497,0.7779692372780057,66,44,19,17,7,7,34,27,3,15
"wisconsin_exoplanets-geminipro,wisconsin_exoplanets-llamaphi,wisconsin_exoplanets-openaio1","2,1,2",0.8412698412698413,0.7274019825071563,0.9211661892477585,63,53,0.6515151515151515,0.5242397683271001,0.7647080305896783,66,43,18,17,6,8,35,26,4,15
"wisconsin_exoplanets-anthropic37,wisconsin_exoplanets-deepseek,wisconsin_exoplanets-openai4510","2,1,2",0.8412698412698413,0.7274019825071563,0.9211661892477585,63,53,0.803030303030303,0.6867611541519056,0.8907397343822825,66,53,15,25,3,6,38,28,7,7
"wisconsin_exoplanets-anthropic,wisconsin_exoplanets-anthropic37,wisconsin_exoplanets-qwq","2,2,1",0.8412698412698413,0.7274019825071563,0.9211661892477585,63,53,0.7878787878787878,0.6697885403521799,0.8788980677448571,66,52,19,26,7,8,34,26,3,6
"wisconsin_exoplanets-anthropic,wisconsin_exoplanets-anthropic37,wisconsin_exoplanets-openai10o1","2,2,5",0.8412698412698413,0.7274019825071563,0.9211661892477585,63,53,0.7575757575757576,0.6363888076622838,0.8546316735018541,66,50,21,29,9,13,32,21,1,3
"wisconsin_exoplanets-anthropic,wisconsin_exoplanets-anthropic3710,wisconsin_exoplanets-falcon","2,5,1",0.8412698412698413,0.7274019825071563,0.9211661892477585,63,53,0.8181818181818182,0.7039345441700697,0.9023647979841516,66,54,18,26,6,6,35,28,4,6
"wisconsin_exoplanets-anthropic,wisconsin_exoplanets-anthropic37,wisconsin_exoplanets-openai10","2,2,5",0.8412698412698413,0.7274019825071563,0.9211661892477585,63,53,0.7272727272727273,0.6036427957562946,0.8296733838204806,66,48,21,29,9,15,32,19,1,3
"wisconsin_exoplanets-anthropic37,wisconsin_exoplanets-falcon10,wisconsin_exoplanets-gemini","2,1,7",0.8412698412698413,0.7274019825071563,0.9211661892477585,63,53,0.7121212121212122,0.5874932401392494,0.816959774581892,66,47,18,25,6,12,35,22,4,7
"wisconsin_exoplanets-anthropic37,wisconsin_exoplanets-falcon10,wisconsin_exoplanets-gemini10","2,1,2",0.8412698412698413,0.7274019825071563,0.9211661892477585,63,53,0.7121212121212122,0.5874932401392494,0.816959774581892,66,47,15,20,3,7,38,27,7,12
"wisconsin_exoplanets-anthropic37,wisconsin_exoplanets-falcon10,wisconsin_exoplanets-openai4510","2,1,2",0.8412698412698413,0.7274019825071563,0.9211661892477585,63,53,0.7575757575757576,0.6363888076622838,0.8546316735018541,66,50,16,24,4,8,37,26,6,8
"wisconsin_exoplanets-gemini,wisconsin_exoplanets-llamaphi,wisconsin_exoplanets-openai4510","7,1,2",0.8412698412698413,0.7274019825071563,0.9211661892477585,63,53,0.7424242424242424,0.6199387593265298,0.8422336207426879,66,49,20,24,8,9,33,25,2,8
"wisconsin_exoplanets-geminipro,wisconsin_exoplanets-openai45,wisconsin_exoplanets-openaio1","2,4,2",0.8412698412698413,0.7274019825071563,0.9211661892477585,63,53,0.6666666666666666,0.5398613431497497,0.7779692372780057,66,44,19,18,7,8,34,26,3,14
"wisconsin_exoplanets-anthropic,wisconsin_exoplanets-anthropic3710,wisconsin_exoplanets-gemini10","2,5,2",0.8412698412698413,0.7274019825071563,0.9211661892477585,63,53,0.8333333333333334,0.7213265468376222,0.9137520659512851,66,55,14,24,2,3,39,31,8,8
"wisconsin_exoplanets-anthropic,wisconsin_exoplanets-anthropic37,wisconsin_exoplanets-llamaphi","2,2,1",0.8412698412698413,0.7274019825071563,0.9211661892477585,63,53,0.7424242424242424,0.6199387593265298,0.8422336207426879,66,49,22,29,10,14,31,20,0,3
"wisconsin_exoplanets-anthropic,wisconsin_exoplanets-anthropic3710,wisconsin_exoplanets-openai10o1","2,5,5",0.8412698412698413,0.7274019825071563,0.9211661892477585,63,53,0.8333333333333334,0.7213265468376222,0.9137520659512851,66,55,21,30,9,9,32,25,1,2
"wisconsin_exoplanets-anthropic37,wisconsin_exoplanets-gemini10,wisconsin_exoplanets-gemma","2,2,1",0.8412698412698413,0.7274019825071563,0.9211661892477585,63,53,0.6666666666666666,0.5398613431497497,0.7779692372780057,66,44,14,16,2,6,39,28,8,16
"wisconsin_exoplanets-anthropic,wisconsin_exoplanets-anthropic3710,wisconsin_exoplanets-openailong","2,5,4",0.8412698412698413,0.7274019825071563,0.9211661892477585,63,53,0.8181818181818182,0.7039345441700697,0.9023647979841516,66,54,21,30,9,10,32,24,1,2
"wisconsin_exoplanets-anthropic3710,wisconsin_exoplanets-openai10,wisconsin_exoplanets-openaio1","5,5,2",0.8412698412698413,0.7274019825071563,0.9211661892477585,63,53,0.7575757575757576,0.6363888076622838,0.8546316735018541,66,50,20,28,8,12,33,22,2,4
"wisconsin_exoplanets-geminipro10,wisconsin_exoplanets-openai,wisconsin_exoplanets-openai4510","3,6,2",0.8412698412698413,0.7274019825071563,0.9211661892477585,63,53,0.7424242424242424,0.6199387593265298,0.8422336207426879,66,49,14,17,2,2,39,32,8,15
"wisconsin_exoplanets-anthropic,wisconsin_exoplanets-deepseek,wisconsin_exoplanets-openai4510","2,1,2",0.8412698412698413,0.7274019825071563,0.9211661892477585,63,53,0.8484848484848485,0.7389589287110891,0.9248753700606944,66,56,15,22,3,0,38,34,7,10
"wisconsin_exoplanets-anthropic,wisconsin_exoplanets-gemini,wisconsin_exoplanets-geminipro","2,7,2",0.8412698412698413,0.7274019825071563,0.9211661892477585,63,53,0.696969696969697,0.5714834854226349,0.8041003533935258,66,46,14,14,2,2,39,32,8,18
"wisconsin_exoplanets-anthropic37,wisconsin_exoplanets-deepseek,wisconsin_exoplanets-geminipro","2,1,2",0.8412698412698413,0.7274019825071563,0.9211661892477585,63,53,0.7424242424242424,0.6199387593265298,0.8422336207426879,66,49,14,21,2,6,39,28,8,11
"wisconsin_exoplanets-falcon10,wisconsin_exoplanets-gemini,wisconsin_exoplanets-openaio1","1,7,2",0.8412698412698413,0.7274019825071563,0.9211661892477585,63,53,0.6666666666666666,0.5398613431497497,0.7779692372780057,66,44,18,18,6,8,35,26,4,14
"wisconsin_exoplanets-gemini,wisconsin_exoplanets-openaio1,wisconsin_exoplanets-phi","7,2,1",0.8412698412698413,0.7274019825071563,0.9211661892477585,63,53,0.6666666666666666,0.5398613431497497,0.7779692372780057,66,44,16,16,4,6,37,28,6,16
"wisconsin_exoplanets-gemini10,wisconsin_exoplanets-openailong,wisconsin_exoplanets-openaio1","2,4,2",0.8412698412698413,0.7274019825071563,0.9211661892477585,63,53,0.6818181818181818,0.5556078292305275,0.7911016327585585,66,45,18,18,6,7,35,27,4,14
"wisconsin_exoplanets-anthropic,wisconsin_exoplanets-gemma,wisconsin_exoplanets-openai4510","2,1,2",0.8412698412698413,0.7274019825071563,0.9211661892477585,63,53,0.7121212121212122,0.5874932401392494,0.816959774581892,66,47,16,15,4,2,37,32,6,17
"wisconsin_exoplanets-anthropic37,wisconsin_exoplanets-openai10o1,wisconsin_exoplanets-openaio1","2,5,2",0.8412698412698413,0.7274019825071563,0.9211661892477585,63,53,0.7575757575757576,0.6363888076622838,0.8546316735018541,66,50,22,31,10,15,31,19,0,1
"wisconsin_exoplanets-gemini,wisconsin_exoplanets-gemini10,wisconsin_exoplanets-phi","7,2,1",0.8412698412698413,0.7274019825071563,0.9211661892477585,63,53,0.6515151515151515,0.5242397683271001,0.7647080305896783,66,43,12,12,0,3,41,31,10,20
"wisconsin_exoplanets-openai4510,wisconsin_exoplanets-openaio1,wisconsin_exoplanets-phi","2,2,1",0.8412698412698413,0.7274019825071563,0.9211661892477585,63,53,0.6666666666666666,0.5398613431497497,0.7779692372780057,66,44,14,13,2,3,39,31,8,19
"wisconsin_exoplanets-anthropic3710,wisconsin_exoplanets-gemini,wisconsin_exoplanets-openai10o1","5,7,5",0.8412698412698413,0.7274019825071563,0.9211661892477585,63,53,0.7727272727272727,0.6530018980228203,0.8668572164845951,66,51,21,29,9,12,32,22,1,3
"wisconsin_exoplanets-anthropic3710,wisconsin_exoplanets-gemini,wisconsin_exoplanets-openai45","5,7,4",0.8412698412698413,0.7274019825071563,0.9211661892477585,63,53,0.803030303030303,0.6867611541519056,0.8907397343822825,66,53,21,30,9,11,32,23,1,2
"wisconsin_exoplanets-anthropic3710,wisconsin_exoplanets-gemini10,wisconsin_exoplanets-gemma","5,2,1",0.8412698412698413,0.7274019825071563,0.9211661892477585,63,53,0.6666666666666666,0.5398613431497497,0.7779692372780057,66,44,12,13,0,3,41,31,10,19
"wisconsin_exoplanets-anthropic37,wisconsin_exoplanets-openailong,wisconsin_exoplanets-openaio1","2,4,2",0.8412698412698413,0.7274019825071563,0.9211661892477585,63,53,0.7121212121212122,0.5874932401392494,0.816959774581892,66,47,22,30,10,17,31,17,0,2
"wisconsin_exoplanets-anthropic3710,wisconsin_exoplanets-falcon10,wisconsin_exoplanets-openaio1","5,1,2",0.8412698412698413,0.7274019825071563,0.9211661892477585,63,53,0.7121212121212122,0.5874932401392494,0.816959774581892,66,47,18,24,6,11,35,23,4,8
"wisconsin_exoplanets-anthropic,wisconsin_exoplanets-llamaphi,wisconsin_exoplanets-openai4510","2,1,2",0.8412698412698413,0.7274019825071563,0.9211661892477585,63,53,0.8484848484848485,0.7389589287110891,0.9248753700606944,66,56,22,28,10,6,31,28,0,4
"wisconsin_exoplanets-anthropic,wisconsin_exoplanets-openai45,wisconsin_exoplanets-openailong","2,4,4",0.8412698412698413,0.7274019825071563,0.9211661892477585,63,53,0.8484848484848485,0.7389589287110891,0.9248753700606944,66,56,19,27,7,5,34,29,3,5
"wisconsin_exoplanets-anthropic37,wisconsin_exoplanets-openaio1,wisconsin_exoplanets-qwq","2,2,1",0.8412698412698413,0.7274019825071563,0.9211661892477585,63,53,0.6666666666666666,0.5398613431497497,0.7779692372780057,66,44,18,19,6,9,35,25,4,13
"wisconsin_exoplanets-gemini,wisconsin_exoplanets-openai4510,wisconsin_exoplanets-phi","7,2,1",0.8412698412698413,0.7274019825071563,0.9211661892477585,63,53,0.6818181818181818,0.5556078292305275,0.7911016327585585,66,45,13,15,1,4,40,30,9,17
"wisconsin_exoplanets-anthropic3710,wisconsin_exoplanets-geminipro,wisconsin_exoplanets-openai10o1","5,2,5",0.8412698412698413,0.7274019825071563,0.9211661892477585,63,53,0.803030303030303,0.6867611541519056,0.8907397343822825,66,53,16,27,4,8,37,26,6,5
"wisconsin_exoplanets-anthropic37,wisconsin_exoplanets-llamaphi,wisconsin_exoplanets-openaio1","2,1,2",0.8412698412698413,0.7274019825071563,0.9211661892477585,63,53,0.7272727272727273,0.6036427957562946,0.8296733838204806,66,48,22,30,10,16,31,18,0,2
"wisconsin_exoplanets-gemini10,wisconsin_exoplanets-openai,wisconsin_exoplanets-openai4510","2,6,2",0.8412698412698413,0.7274019825071563,0.9211661892477585,63,53,0.7878787878787878,0.6697885403521799,0.8788980677448571,66,52,12,19,0,1,41,33,10,13
"wisconsin_exoplanets-anthropic3710,wisconsin_exoplanets-geminipro10,wisconsin_exoplanets-openai10o1","5,3,5",0.8412698412698413,0.7274019825071563,0.9211661892477585,63,53,0.803030303030303,0.6867611541519056,0.8907397343822825,66,53,17,27,5,8,36,26,5,5
"wisconsin_exoplanets-anthropic3710,wisconsin_exoplanets-geminipro10,wisconsin_exoplanets-openai10","5,3,5",0.8412698412698413,0.7274019825071563,0.9211661892477585,63,53,0.803030303030303,0.6867611541519056,0.8907397343822825,66,53,17,28,5,9,36,25,5,4
"wisconsin_exoplanets-anthropic,wisconsin_exoplanets-gemini,wisconsin_exoplanets-openaio1","2,7,2",0.8412698412698413,0.7274019825071563,0.9211661892477585,63,53,0.7272727272727273,0.6036427957562946,0.8296733838204806,66,48,19,21,7,7,34,27,3,11
"wisconsin_exoplanets-anthropic37,wisconsin_exoplanets-openai45,wisconsin_exoplanets-openaio1","2,4,2",0.8412698412698413,0.7274019825071563,0.9211661892477585,63,53,0.7272727272727273,0.6036427957562946,0.8296733838204806,66,48,22,30,10,16,31,18,0,2
"wisconsin_exoplanets-openai10,wisconsin_exoplanets-openai10o1,wisconsin_exoplanets-openaio1","5,5,2",0.8301886792452831,0.7019783318945976,0.9192911235331771,53,44,0.8571428571428571,0.7529317522496477,0.9293095457331302,70,60,15,20,2,6,29,40,7,4
"wisconsin_exoplanets-openai10,wisconsin_exoplanets-openai4510,wisconsin_exoplanets-qwq","5,2,1",0.8301886792452831,0.7019783318945976,0.9192911235331771,53,44,0.8571428571428571,0.7529317522496477,0.9293095457331302,70,60,15,19,2,5,29,41,7,5
"wisconsin_exoplanets-deepseek,wisconsin_exoplanets-gemini,wisconsin_exoplanets-openaio1","1,7,2",0.8253968253968254,0.709029050919127,0.9094810154370034,63,52,0.6818181818181818,0.5556078292305275,0.7911016327585585,66,45,18,18,7,7,34,27,4,14
"wisconsin_exoplanets-anthropic,wisconsin_exoplanets-openai10o1,wisconsin_exoplanets-openai4510","2,5,2",0.8253968253968254,0.709029050919127,0.9094810154370034,63,52,0.8181818181818182,0.7039345441700697,0.9023647979841516,66,54,20,26,9,6,32,28,2,6
"wisconsin_exoplanets-anthropic3710,wisconsin_exoplanets-gemini,wisconsin_exoplanets-llamaphi","5,7,1",0.8253968253968254,0.709029050919127,0.9094810154370034,63,52,0.7727272727272727,0.6530018980228203,0.8668572164845951,66,51,21,29,10,12,31,22,1,3
"wisconsin_exoplanets-gemini10,wisconsin_exoplanets-openai10,wisconsin_exoplanets-openaio1","2,5,2",0.8253968253968254,0.709029050919127,0.9094810154370034,63,52,0.6818181818181818,0.5556078292305275,0.7911016327585585,66,45,17,18,6,7,35,27,5,14
"wisconsin_exoplanets-gemini,wisconsin_exoplanets-openai45,wisconsin_exoplanets-openai4510","7,4,2",0.8253968253968254,0.709029050919127,0.9094810154370034,63,52,0.7727272727272727,0.6530018980228203,0.8668572164845951,66,51,20,26,9,9,32,25,2,6
"wisconsin_exoplanets-geminipro,wisconsin_exoplanets-openailong,wisconsin_exoplanets-openaio1","2,4,2",0.8253968253968254,0.709029050919127,0.9094810154370034,63,52,0.6666666666666666,0.5398613431497497,0.7779692372780057,66,44,18,18,7,8,34,26,4,14
"wisconsin_exoplanets-anthropic37,wisconsin_exoplanets-gemini,wisconsin_exoplanets-openai","2,7,6",0.8253968253968254,0.709029050919127,0.9094810154370034,63,52,0.7272727272727273,0.6036427957562946,0.8296733838204806,66,48,22,30,11,16,30,18,0,2
"wisconsin_exoplanets-anthropic3710,wisconsin_exoplanets-gemini,wisconsin_exoplanets-gemini10","5,7,2",0.8253968253968254,0.709029050919127,0.9094810154370034,63,52,0.7272727272727273,0.6036427957562946,0.8296733838204806,66,48,12,18,1,4,40,30,10,14
"wisconsin_exoplanets-gemini,wisconsin_exoplanets-openai10o1,wisconsin_exoplanets-openai4510","7,5,2",0.8253968253968254,0.709029050919127,0.9094810154370034,63,52,0.7727272727272727,0.6530018980228203,0.8668572164845951,66,51,19,25,8,8,33,26,3,7
"wisconsin_exoplanets-gemini10,wisconsin_exoplanets-openai4510,wisconsin_exoplanets-openailong","2,2,4",0.8253968253968254,0.709029050919127,0.9094810154370034,63,52,0.803030303030303,0.6867611541519056,0.8907397343822825,66,53,12,20,1,1,40,33,10,12
"wisconsin_exoplanets-geminipro,wisconsin_exoplanets-openai10o1,wisconsin_exoplanets-openaio1","2,5,2",0.8253968253968254,0.709029050919127,0.9094810154370034,63,52,0.6515151515151515,0.5242397683271001,0.7647080305896783,66,43,17,17,6,8,35,26,5,15
"wisconsin_exoplanets-anthropic37,wisconsin_exoplanets-falcon10,wisconsin_exoplanets-geminipro10","2,1,3",0.8253968253968254,0.709029050919127,0.9094810154370034,63,52,0.7272727272727273,0.6036427957562946,0.8296733838204806,66,48,14,21,3,7,38,27,8,11
"wisconsin_exoplanets-gemini10,wisconsin_exoplanets-llamaphi,wisconsin_exoplanets-openai4510","2,1,2",0.8253968253968254,0.709029050919127,0.9094810154370034,63,52,0.7878787878787878,0.6697885403521799,0.8788980677448571,66,52,12,19,1,1,40,33,10,13
"wisconsin_exoplanets-anthropic3710,wisconsin_exoplanets-falcon,wisconsin_exoplanets-openaio1","5,1,2",0.8253968253968254,0.709029050919127,0.9094810154370034,63,52,0.7575757575757576,0.6363888076622838,0.8546316735018541,66,50,18,23,7,7,34,27,4,9
"wisconsin_exoplanets-anthropic,wisconsin_exoplanets-anthropic3710,wisconsin_exoplanets-geminipro10","2,5,3",0.8253968253968254,0.709029050919127,0.9094810154370034,63,52,0.8333333333333334,0.7213265468376222,0.9137520659512851,66,55,14,24,3,3,38,31,8,8
"wisconsin_exoplanets-gemini10,wisconsin_exoplanets-openai45,wisconsin_exoplanets-openai4510","2,4,2",0.8253968253968254,0.709029050919127,0.9094810154370034,63,52,0.803030303030303,0.6867611541519056,0.8907397343822825,66,53,12,20,1,1,40,33,10,12
"wisconsin_exoplanets-anthropic,wisconsin_exoplanets-anthropic3710,wisconsin_exoplanets-geminipro","2,5,2",0.8253968253968254,0.709029050919127,0.9094810154370034,63,52,0.8333333333333334,0.7213265468376222,0.9137520659512851,66,55,14,24,3,3,38,31,8,8
"wisconsin_exoplanets-gemini,wisconsin_exoplanets-openai10o1,wisconsin_exoplanets-openaio1","7,5,2",0.8253968253968254,0.709029050919127,0.9094810154370034,63,52,0.6363636363636364,0.5087394315103153,0.7513222169426668,66,42,20,21,9,13,32,21,2,11
"wisconsin_exoplanets-geminipro,wisconsin_exoplanets-openai,wisconsin_exoplanets-openai4510","2,6,2",0.8253968253968254,0.709029050919127,0.9094810154370034,63,52,0.696969696969697,0.5714834854226349,0.8041003533935258,66,46,12,14,1,2,40,32,10,18
"wisconsin_exoplanets-anthropic37,wisconsin_exoplanets-openai4510,wisconsin_exoplanets-phi","2,2,1",0.8253968253968254,0.709029050919127,0.9094810154370034,63,52,0.696969696969697,0.5714834854226349,0.8041003533935258,66,46,15,19,4,7,37,27,7,13
"wisconsin_exoplanets-anthropic,wisconsin_exoplanets-deepseek,wisconsin_exoplanets-gemini","2,1,7",0.8253968253968254,0.709029050919127,0.9094810154370034,63,52,0.7727272727272727,0.6530018980228203,0.8668572164845951,66,51,17,23,6,6,35,28,5,9
"wisconsin_exoplanets-anthropic,wisconsin_exoplanets-anthropic3710,wisconsin_exoplanets-openai10","2,5,5",0.8253968253968254,0.709029050919127,0.9094810154370034,63,52,0.8181818181818182,0.7039345441700697,0.9023647979841516,66,54,20,30,9,10,32,24,2,2
"wisconsin_exoplanets-geminipro10,wisconsin_exoplanets-openai10o1,wisconsin_exoplanets-openaio1","3,5,2",0.8253968253968254,0.709029050919127,0.9094810154370034,63,52,0.6515151515151515,0.5242397683271001,0.7647080305896783,66,43,18,17,7,8,34,26,4,15
"wisconsin_exoplanets-gemma,wisconsin_exoplanets-openai4510,wisconsin_exoplanets-openaio1","1,2,2",0.8253968253968254,0.709029050919127,0.9094810154370034,63,52,0.6212121212121212,0.4933571772023376,0.7378154230046878,66,41,16,11,5,4,36,30,6,21
"wisconsin_exoplanets-anthropic,wisconsin_exoplanets-gemini,wisconsin_exoplanets-geminipro10","2,7,3",0.8253968253968254,0.709029050919127,0.9094810154370034,63,52,0.7121212121212122,0.5874932401392494,0.816959774581892,66,47,14,15,3,2,38,32,8,17
"wisconsin_exoplanets-anthropic10,wisconsin_exoplanets-anthropic3710,wisconsin_exoplanets-openaio1","1,5,2",0.8253968253968254,0.709029050919127,0.9094810154370034,63,52,0.7121212121212122,0.5874932401392494,0.816959774581892,66,47,16,20,5,7,36,27,6,12
"wisconsin_exoplanets-gemini,wisconsin_exoplanets-gemini10,wisconsin_exoplanets-openaio1","7,2,2",0.8253968253968254,0.709029050919127,0.9094810154370034,63,52,0.7121212121212122,0.5874932401392494,0.816959774581892,66,47,14,16,3,3,38,31,8,16
"wisconsin_exoplanets-deepseek,wisconsin_exoplanets-openai4510,wisconsin_exoplanets-openaio1","1,2,2",0.8253968253968254,0.709029050919127,0.9094810154370034,63,52,0.803030303030303,0.6867611541519056,0.8907397343822825,66,53,14,20,3,1,38,33,8,12
"wisconsin_exoplanets-gemini,wisconsin_exoplanets-gemma,wisconsin_exoplanets-openai4510","7,1,2",0.8253968253968254,0.709029050919127,0.9094810154370034,63,52,0.5757575757575758,0.4478940377087594,0.6965980669616616,66,38,14,10,3,6,38,28,8,22
"wisconsin_exoplanets-anthropic3710,wisconsin_exoplanets-geminipro,wisconsin_exoplanets-openai4510","5,2,2",0.8253968253968254,0.709029050919127,0.9094810154370034,63,52,0.7121212121212122,0.5874932401392494,0.816959774581892,66,47,11,13,0,0,41,34,11,19
"wisconsin_exoplanets-anthropic,wisconsin_exoplanets-gemini10,wisconsin_exoplanets-openai45","2,2,4",0.8253968253968254,0.709029050919127,0.9094810154370034,63,52,0.8484848484848485,0.7389589287110891,0.9248753700606944,66,56,18,26,7,4,34,30,4,6
"wisconsin_exoplanets-anthropic3710,wisconsin_exoplanets-geminipro,wisconsin_exoplanets-llama","5,2,2",0.8253968253968254,0.709029050919127,0.9094810154370034,63,52,0.7424242424242424,0.6199387593265298,0.8422336207426879,66,49,12,20,1,5,40,29,10,12
"wisconsin_exoplanets-geminipro10,wisconsin_exoplanets-openai4510,wisconsin_exoplanets-openailong","3,2,4",0.8253968253968254,0.709029050919127,0.9094810154370034,63,52,0.7575757575757576,0.6363888076622838,0.8546316735018541,66,50,14,18,3,2,38,32,8,14
"wisconsin_exoplanets-geminipro10,wisconsin_exoplanets-openai45,wisconsin_exoplanets-openaio1","3,4,2",0.8253968253968254,0.709029050919127,0.9094810154370034,63,52,0.6666666666666666,0.5398613431497497,0.7779692372780057,66,44,19,18,8,8,33,26,3,14
"wisconsin_exoplanets-anthropic3710,wisconsin_exoplanets-gemini10,wisconsin_exoplanets-phi","5,2,1",0.8253968253968254,0.709029050919127,0.9094810154370034,63,52,0.7575757575757576,0.6363888076622838,0.8546316735018541,66,50,12,18,1,2,40,32,10,14
"wisconsin_exoplanets-geminipro10,wisconsin_exoplanets-openai45,wisconsin_exoplanets-openai4510","3,4,2",0.8253968253968254,0.709029050919127,0.9094810154370034,63,52,0.7575757575757576,0.6363888076622838,0.8546316735018541,66,50,14,18,3,2,38,32,8,14
"wisconsin_exoplanets-anthropic3710,wisconsin_exoplanets-gemini10,wisconsin_exoplanets-openai4510","5,2,2",0.8253968253968254,0.709029050919127,0.9094810154370034,63,52,0.7878787878787878,0.6697885403521799,0.8788980677448571,66,52,11,18,0,0,41,34,11,14
"wisconsin_exoplanets-anthropic37,wisconsin_exoplanets-gemini,wisconsin_exoplanets-qwq","2,7,1",0.8253968253968254,0.709029050919127,0.9094810154370034,63,52,0.6515151515151515,0.5242397683271001,0.7647080305896783,66,43,17,20,6,11,35,23,5,12
"wisconsin_exoplanets-anthropic,wisconsin_exoplanets-geminipro,wisconsin_exoplanets-openai45","2,2,4",0.8253968253968254,0.709029050919127,0.9094810154370034,63,52,0.8333333333333334,0.7213265468376222,0.9137520659512851,66,55,18,26,7,5,34,29,4,6
"wisconsin_exoplanets-anthropic10,wisconsin_exoplanets-anthropic37,wisconsin_exoplanets-openai4510","1,2,2",0.8253968253968254,0.709029050919127,0.9094810154370034,63,52,0.7272727272727273,0.6036427957562946,0.8296733838204806,66,48,14,22,3,8,38,26,8,10
"wisconsin_exoplanets-anthropic3710,wisconsin_exoplanets-openai4510,wisconsin_exoplanets-phi","5,2,1",0.8253968253968254,0.709029050919127,0.9094810154370034,63,52,0.7575757575757576,0.6363888076622838,0.8546316735018541,66,50,13,19,2,3,39,31,9,13
"wisconsin_exoplanets-anthropic,wisconsin_exoplanets-anthropic37,wisconsin_exoplanets-falcon","2,2,1",0.8253968253968254,0.709029050919127,0.9094810154370034,63,52,0.8333333333333334,0.7213265468376222,0.9137520659512851,66,55,18,28,7,7,34,27,4,4
"wisconsin_exoplanets-anthropic37,wisconsin_exoplanets-openai10,wisconsin_exoplanets-openaio1","2,5,2",0.8253968253968254,0.709029050919127,0.9094810154370034,63,52,0.7272727272727273,0.6036427957562946,0.8296733838204806,66,48,22,31,11,17,30,17,0,1
"wisconsin_exoplanets-anthropic3710,wisconsin_exoplanets-gemini,wisconsin_exoplanets-qwq","5,7,1",0.8253968253968254,0.709029050919127,0.9094810154370034,63,52,0.696969696969697,0.5714834854226349,0.8041003533935258,66,46,17,20,6,8,35,26,5,12
"wisconsin_exoplanets-anthropic3710,wisconsin_exoplanets-gemini,wisconsin_exoplanets-openailong","5,7,4",0.8253968253968254,0.709029050919127,0.9094810154370034,63,52,0.7878787878787878,0.6697885403521799,0.8788980677448571,66,52,20,30,9,12,32,22,2,2
"wisconsin_exoplanets-anthropic37,wisconsin_exoplanets-gemini10,wisconsin_exoplanets-openai4510","2,2,2",0.8253968253968254,0.709029050919127,0.9094810154370034,63,52,0.803030303030303,0.6867611541519056,0.8907397343822825,66,53,12,20,1,1,40,33,10,12
"wisconsin_exoplanets-geminipro10,wisconsin_exoplanets-llamaphi,wisconsin_exoplanets-openaio1","3,1,2",0.8253968253968254,0.709029050919127,0.9094810154370034,63,52,0.6515151515151515,0.5242397683271001,0.7647080305896783,66,43,18,17,7,8,34,26,4,15
"wisconsin_exoplanets-anthropic3710,wisconsin_exoplanets-gemini,wisconsin_exoplanets-openai","5,7,6",0.8253968253968254,0.709029050919127,0.9094810154370034,63,52,0.7878787878787878,0.6697885403521799,0.8788980677448571,66,52,21,30,10,12,31,22,1,2
"wisconsin_exoplanets-anthropic,wisconsin_exoplanets-gemini,wisconsin_exoplanets-llama","2,7,2",0.8253968253968254,0.709029050919127,0.9094810154370034,63,52,0.8333333333333334,0.7213265468376222,0.9137520659512851,66,55,17,26,6,5,35,29,5,6
"wisconsin_exoplanets-gemini10,wisconsin_exoplanets-openaio1,wisconsin_exoplanets-phi","2,2,1",0.8253968253968254,0.709029050919127,0.9094810154370034,63,52,0.6666666666666666,0.5398613431497497,0.7779692372780057,66,44,12,12,1,2,40,32,10,20
"wisconsin_exoplanets-anthropic10,wisconsin_exoplanets-anthropic37,wisconsin_exoplanets-gemini","1,2,7",0.8253968253968254,0.709029050919127,0.9094810154370034,63,52,0.6363636363636364,0.5087394315103153,0.7513222169426668,66,42,17,23,6,15,35,19,5,9
"wisconsin_exoplanets-anthropic,wisconsin_exoplanets-openai10,wisconsin_exoplanets-openai4510","2,5,2",0.8253968253968254,0.709029050919127,0.9094810154370034,63,52,0.8484848484848485,0.7389589287110891,0.9248753700606944,66,56,20,28,9,6,32,28,2,4
"wisconsin_exoplanets-openai10o1,wisconsin_exoplanets-openai45,wisconsin_exoplanets-qwq","5,4,1",0.8113207547169812,0.6802756476579374,0.905630223930908,53,43,0.6545454545454545,0.5141850490606814,0.7776251221571671,55,36,16,7,2,5,27,29,8,14
"wisconsin_exoplanets-openai10,wisconsin_exoplanets-openai10o1,wisconsin_exoplanets-phi","5,5,1",0.8113207547169812,0.6802756476579374,0.905630223930908,53,43,0.8428571428571429,0.7362002347836887,0.9188562364495523,70,59,15,20,3,7,28,39,7,4
"wisconsin_exoplanets-openai10,wisconsin_exoplanets-openai10o1,wisconsin_exoplanets-qwq","5,5,1",0.8113207547169812,0.6802756476579374,0.905630223930908,53,43,0.8571428571428571,0.7529317522496477,0.9293095457331302,70,60,15,20,3,6,28,40,7,4
"wisconsin_exoplanets-openai10,wisconsin_exoplanets-openai45,wisconsin_exoplanets-openaio1","5,4,2",0.8113207547169812,0.6802756476579374,0.905630223930908,53,43,0.7428571428571429,0.6243856142763229,0.8399301090675972,70,52,21,20,9,14,22,32,1,4
"wisconsin_exoplanets-openai10o1,wisconsin_exoplanets-openailong,wisconsin_exoplanets-qwq","5,4,1",0.8113207547169812,0.6802756476579374,0.905630223930908,53,43,0.6727272727272727,0.532928951764585,0.7931918831325926,55,37,15,7,1,4,28,30,9,14
"wisconsin_exoplanets-openai10o1,wisconsin_exoplanets-openailong,wisconsin_exoplanets-phi","5,4,1",0.8113207547169812,0.6802756476579374,0.905630223930908,53,43,0.6909090909090909,0.5518702546562255,0.8085535885663784,55,38,15,7,1,3,28,31,9,14
"wisconsin_exoplanets-openai10o1,wisconsin_exoplanets-openai45,wisconsin_exoplanets-phi","5,4,1",0.8113207547169812,0.6802756476579374,0.905630223930908,53,43,0.6727272727272727,0.532928951764585,0.7931918831325926,55,37,16,7,2,4,27,30,8,14
"wisconsin_exoplanets-openai10,wisconsin_exoplanets-openai10o1,wisconsin_exoplanets-openai4510","5,5,2",0.8113207547169812,0.6802756476579374,0.905630223930908,53,43,0.8714285714285714,0.7699116098309631,0.9394866858096107,70,61,14,20,2,5,29,41,8,4
"wisconsin_exoplanets-deepseek,wisconsin_exoplanets-geminipro10,wisconsin_exoplanets-openaio1","1,3,2",0.8095238095238095,0.6909115309144422,0.8975157564061429,63,51,0.7272727272727273,0.6036427957562946,0.8296733838204806,66,48,13,16,3,2,38,32,9,16
"wisconsin_exoplanets-anthropic3710,wisconsin_exoplanets-gemini,wisconsin_exoplanets-geminipro","5,7,2",0.8095238095238095,0.6909115309144422,0.8975157564061429,63,51,0.6666666666666666,0.5398613431497497,0.7779692372780057,66,44,12,15,2,5,39,29,10,17
"wisconsin_exoplanets-gemini,wisconsin_exoplanets-openai4510,wisconsin_exoplanets-openailong","7,2,4",0.8095238095238095,0.6909115309144422,0.8975157564061429,63,51,0.7727272727272727,0.6530018980228203,0.8668572164845951,66,51,19,26,9,9,32,25,3,6
"wisconsin_exoplanets-anthropic3710,wisconsin_exoplanets-falcon10,wisconsin_exoplanets-openai4510","5,1,2",0.8095238095238095,0.6909115309144422,0.8975157564061429,63,51,0.8181818181818182,0.7039345441700697,0.9023647979841516,66,54,13,24,3,4,38,30,9,8
"wisconsin_exoplanets-gemini10,wisconsin_exoplanets-openai10,wisconsin_exoplanets-openai4510","2,5,2",0.8095238095238095,0.6909115309144422,0.8975157564061429,63,51,0.803030303030303,0.6867611541519056,0.8907397343822825,66,53,11,20,1,1,40,33,11,12
"wisconsin_exoplanets-anthropic3710,wisconsin_exoplanets-falcon10,wisconsin_exoplanets-gemini10","5,1,2",0.8095238095238095,0.6909115309144422,0.8975157564061429,63,51,0.7575757575757576,0.6363888076622838,0.8546316735018541,66,50,13,20,3,4,38,30,9,12
"wisconsin_exoplanets-gemini,wisconsin_exoplanets-openai10,wisconsin_exoplanets-openai4510","7,5,2",0.8095238095238095,0.6909115309144422,0.8975157564061429,63,51,0.7727272727272727,0.6530018980228203,0.8668572164845951,66,51,19,26,9,9,32,25,3,6
"wisconsin_exoplanets-gemini,wisconsin_exoplanets-geminipro,wisconsin_exoplanets-openaio1","7,2,2",0.8095238095238095,0.6909115309144422,0.8975157564061429,63,51,0.6515151515151515,0.5242397683271001,0.7647080305896783,66,43,14,13,4,4,37,30,8,19
"wisconsin_exoplanets-anthropic,wisconsin_exoplanets-anthropic10,wisconsin_exoplanets-anthropic3710","2,1,5",0.8095238095238095,0.6909115309144422,0.8975157564061429,63,51,0.8787878787878788,0.7750598442768422,0.9461891381581342,66,58,16,28,6,4,35,30,6,4
"wisconsin_exoplanets-gemini,wisconsin_exoplanets-openaio1,wisconsin_exoplanets-qwq","7,2,1",0.8095238095238095,0.6909115309144422,0.8975157564061429,63,51,0.696969696969697,0.5714834854226349,0.8041003533935258,66,46,17,18,7,6,34,28,5,14
"wisconsin_exoplanets-gemini,wisconsin_exoplanets-geminipro,wisconsin_exoplanets-phi","7,2,1",0.8095238095238095,0.6909115309144422,0.8975157564061429,63,51,0.5909090909090909,0.46293656355858825,0.7104508976039902,66,39,11,9,1,4,40,30,11,23
"wisconsin_exoplanets-deepseek,wisconsin_exoplanets-gemini10,wisconsin_exoplanets-openaio1","1,2,2",0.8095238095238095,0.6909115309144422,0.8975157564061429,63,51,0.7424242424242424,0.6199387593265298,0.8422336207426879,66,49,13,16,3,1,38,33,9,16
"wisconsin_exoplanets-anthropic3710,wisconsin_exoplanets-falcon,wisconsin_exoplanets-gemini","5,1,7",0.8095238095238095,0.6909115309144422,0.8975157564061429,63,51,0.7575757575757576,0.6363888076622838,0.8546316735018541,66,50,17,24,7,8,34,26,5,8
"wisconsin_exoplanets-anthropic3710,wisconsin_exoplanets-deepseek,wisconsin_exoplanets-geminipro10","5,1,3",0.8095238095238095,0.6909115309144422,0.8975157564061429,63,51,0.7727272727272727,0.6530018980228203,0.8668572164845951,66,51,12,21,2,4,39,30,10,11
"wisconsin_exoplanets-anthropic3710,wisconsin_exoplanets-deepseek,wisconsin_exoplanets-gemini10","5,1,2",0.8095238095238095,0.6909115309144422,0.8975157564061429,63,51,0.7878787878787878,0.6697885403521799,0.8788980677448571,66,52,12,21,2,3,39,31,10,11
"wisconsin_exoplanets-anthropic3710,wisconsin_exoplanets-gemini,wisconsin_exoplanets-openai10","5,7,5",0.8095238095238095,0.6909115309144422,0.8975157564061429,63,51,0.7878787878787878,0.6697885403521799,0.8788980677448571,66,52,20,30,10,12,31,22,2,2
"wisconsin_exoplanets-anthropic37,wisconsin_exoplanets-falcon,wisconsin_exoplanets-openaio1","2,1,2",0.8095238095238095,0.6909115309144422,0.8975157564061429,63,51,0.6818181818181818,0.5556078292305275,0.7911016327585585,66,45,19,21,9,10,32,24,3,11
"wisconsin_exoplanets-anthropic3710,wisconsin_exoplanets-geminipro,wisconsin_exoplanets-phi","5,2,1",0.8095238095238095,0.6909115309144422,0.8975157564061429,63,51,0.6666666666666666,0.5398613431497497,0.7779692372780057,66,44,11,12,1,2,40,32,11,20
"wisconsin_exoplanets-falcon,wisconsin_exoplanets-gemini,wisconsin_exoplanets-openaio1","1,7,2",0.8095238095238095,0.6909115309144422,0.8975157564061429,63,51,0.6666666666666666,0.5398613431497497,0.7779692372780057,66,44,19,17,9,7,32,27,3,15
"wisconsin_exoplanets-deepseek,wisconsin_exoplanets-gemini,wisconsin_exoplanets-gemini10","1,7,2",0.8095238095238095,0.6909115309144422,0.8975157564061429,63,51,0.6818181818181818,0.5556078292305275,0.7911016327585585,66,45,11,16,1,5,40,29,11,16
"wisconsin_exoplanets-falcon10,wisconsin_exoplanets-gemini,wisconsin_exoplanets-openai4510","1,7,2",0.8095238095238095,0.6909115309144422,0.8975157564061429,63,51,0.7121212121212122,0.5874932401392494,0.816959774581892,66,47,13,18,3,5,38,29,9,14
"wisconsin_exoplanets-gemini,wisconsin_exoplanets-gemma,wisconsin_exoplanets-openaio1","7,1,2",0.8095238095238095,0.6909115309144422,0.8975157564061429,63,51,0.6363636363636364,0.5087394315103153,0.7513222169426668,66,42,17,15,7,7,34,27,5,17
"wisconsin_exoplanets-anthropic3710,wisconsin_exoplanets-geminipro10,wisconsin_exoplanets-phi","5,3,1",0.8095238095238095,0.6909115309144422,0.8975157564061429,63,51,0.696969696969697,0.5714834854226349,0.8041003533935258,66,46,11,14,1,2,40,32,11,18
"wisconsin_exoplanets-anthropic37,wisconsin_exoplanets-geminipro,wisconsin_exoplanets-openai4510","2,2,2",0.8095238095238095,0.6909115309144422,0.8975157564061429,63,51,0.7272727272727273,0.6036427957562946,0.8296733838204806,66,48,11,15,1,1,40,33,11,17
"wisconsin_exoplanets-anthropic3710,wisconsin_exoplanets-deepseek,wisconsin_exoplanets-openai4510","5,1,2",0.8095238095238095,0.6909115309144422,0.8975157564061429,63,51,0.8484848484848485,0.7389589287110891,0.9248753700606944,66,56,12,25,2,3,39,31,10,7
"wisconsin_exoplanets-falcon10,wisconsin_exoplanets-openai4510,wisconsin_exoplanets-openaio1","1,2,2",0.8095238095238095,0.6909115309144422,0.8975157564061429,63,51,0.7272727272727273,0.6036427957562946,0.8296733838204806,66,48,14,18,4,4,37,30,8,14
"wisconsin_exoplanets-anthropic37,wisconsin_exoplanets-gemini,wisconsin_exoplanets-openailong","2,7,4",0.8095238095238095,0.6909115309144422,0.8975157564061429,63,51,0.7272727272727273,0.6036427957562946,0.8296733838204806,66,48,22,31,12,17,29,17,0,1
"wisconsin_exoplanets-anthropic37,wisconsin_exoplanets-gemini,wisconsin_exoplanets-openai45","2,7,4",0.8095238095238095,0.6909115309144422,0.8975157564061429,63,51,0.7424242424242424,0.6199387593265298,0.8422336207426879,66,49,22,31,12,16,29,18,0,1
"wisconsin_exoplanets-anthropic37,wisconsin_exoplanets-gemini,wisconsin_exoplanets-openai10o1","2,7,5",0.8095238095238095,0.6909115309144422,0.8975157564061429,63,51,0.7424242424242424,0.6199387593265298,0.8422336207426879,66,49,22,31,12,16,29,18,0,1
"wisconsin_exoplanets-anthropic37,wisconsin_exoplanets-gemini,wisconsin_exoplanets-llamaphi","2,7,1",0.8095238095238095,0.6909115309144422,0.8975157564061429,63,51,0.696969696969697,0.5714834854226349,0.8041003533935258,66,46,22,30,12,18,29,16,0,2
"wisconsin_exoplanets-anthropic3710,wisconsin_exoplanets-falcon10,wisconsin_exoplanets-geminipro10","5,1,3",0.8095238095238095,0.6909115309144422,0.8975157564061429,63,51,0.7727272727272727,0.6530018980228203,0.8668572164845951,66,51,13,21,3,4,38,30,9,11
"wisconsin_exoplanets-anthropic10,wisconsin_exoplanets-openai4510,wisconsin_exoplanets-openaio1","1,2,2",0.8095238095238095,0.6909115309144422,0.8975157564061429,63,51,0.6818181818181818,0.5556078292305275,0.7911016327585585,66,45,13,17,3,6,38,28,9,15
"wisconsin_exoplanets-anthropic,wisconsin_exoplanets-openai4510,wisconsin_exoplanets-phi","2,2,1",0.8095238095238095,0.6909115309144422,0.8975157564061429,63,51,0.7424242424242424,0.6199387593265298,0.8422336207426879,66,49,15,18,5,3,36,31,7,14
"wisconsin_exoplanets-anthropic,wisconsin_exoplanets-openaio1,wisconsin_exoplanets-qwq","2,2,1",0.8095238095238095,0.6909115309144422,0.8975157564061429,63,51,0.6818181818181818,0.5556078292305275,0.7911016327585585,66,45,19,19,9,8,32,26,3,13
"wisconsin_exoplanets-anthropic,wisconsin_exoplanets-gemini10,wisconsin_exoplanets-openai10o1","2,2,5",0.8095238095238095,0.6909115309144422,0.8975157564061429,63,51,0.8181818181818182,0.7039345441700697,0.9023647979841516,66,54,18,25,8,5,33,29,4,7
"wisconsin_exoplanets-anthropic,wisconsin_exoplanets-gemini10,wisconsin_exoplanets-openailong","2,2,4",0.8095238095238095,0.6909115309144422,0.8975157564061429,63,51,0.8333333333333334,0.7213265468376222,0.9137520659512851,66,55,17,26,7,5,34,29,5,6
"wisconsin_exoplanets-gemini10,wisconsin_exoplanets-openai4510,wisconsin_exoplanets-openaio1","2,2,2",0.8095238095238095,0.6909115309144422,0.8975157564061429,63,51,0.6666666666666666,0.5398613431497497,0.7779692372780057,66,44,10,10,0,0,41,34,12,22
"wisconsin_exoplanets-anthropic,wisconsin_exoplanets-geminipro,wisconsin_exoplanets-openailong","2,2,4",0.8095238095238095,0.6909115309144422,0.8975157564061429,63,51,0.8181818181818182,0.7039345441700697,0.9023647979841516,66,54,17,26,7,6,34,28,5,6
"wisconsin_exoplanets-anthropic,wisconsin_exoplanets-geminipro10,wisconsin_exoplanets-openai45","2,3,4",0.8095238095238095,0.6909115309144422,0.8975157564061429,63,51,0.8333333333333334,0.7213265468376222,0.9137520659512851,66,55,18,26,8,5,33,29,4,6
"wisconsin_exoplanets-anthropic,wisconsin_exoplanets-gemma,wisconsin_exoplanets-openaio1","2,1,2",0.8095238095238095,0.6909115309144422,0.8975157564061429,63,51,0.7121212121212122,0.5874932401392494,0.816959774581892,66,47,19,20,9,7,32,27,3,12
"wisconsin_exoplanets-anthropic,wisconsin_exoplanets-openai,wisconsin_exoplanets-openailong","2,6,4",0.8095238095238095,0.6909115309144422,0.8975157564061429,63,51,0.8484848484848485,0.7389589287110891,0.9248753700606944,66,56,19,27,9,5,32,29,3,5
"wisconsin_exoplanets-anthropic,wisconsin_exoplanets-openai10,wisconsin_exoplanets-openai10o1","2,5,5",0.8095238095238095,0.6909115309144422,0.8975157564061429,63,51,0.8636363636363636,0.7568586684861609,0.9357018153567447,66,57,18,28,8,5,33,29,4,4
"wisconsin_exoplanets-anthropic,wisconsin_exoplanets-openai10,wisconsin_exoplanets-openai45","2,5,4",0.8095238095238095,0.6909115309144422,0.8975157564061429,63,51,0.8484848484848485,0.7389589287110891,0.9248753700606944,66,56,18,27,8,5,33,29,4,5
"wisconsin_exoplanets-anthropic,wisconsin_exoplanets-openai10o1,wisconsin_exoplanets-openailong","2,5,4",0.8095238095238095,0.6909115309144422,0.8975157564061429,63,51,0.8484848484848485,0.7389589287110891,0.9248753700606944,66,56,18,27,8,5,33,29,4,5
"wisconsin_exoplanets-llama,wisconsin_exoplanets-openai4510,wisconsin_exoplanets-openaio1","2,2,2",0.8095238095238095,0.6909115309144422,0.8975157564061429,63,51,0.7272727272727273,0.6036427957562946,0.8296733838204806,66,48,16,19,6,5,35,29,6,13
"wisconsin_exoplanets-anthropic,wisconsin_exoplanets-falcon10,wisconsin_exoplanets-openai4510","2,1,2",0.8095238095238095,0.6909115309144422,0.8975157564061429,63,51,0.803030303030303,0.6867611541519056,0.8907397343822825,66,53,15,22,5,3,36,31,7,10
"wisconsin_exoplanets-anthropic10,wisconsin_exoplanets-anthropic3710,wisconsin_exoplanets-gemini10","1,5,2",0.8095238095238095,0.6909115309144422,0.8975157564061429,63,51,0.7424242424242424,0.6199387593265298,0.8422336207426879,66,49,11,18,1,3,40,31,11,14
"wisconsin_exoplanets-geminipro,wisconsin_exoplanets-openai10,wisconsin_exoplanets-openaio1","2,5,2",0.8095238095238095,0.6909115309144422,0.8975157564061429,63,51,0.6666666666666666,0.5398613431497497,0.7779692372780057,66,44,17,18,7,8,34,26,5,14
"wisconsin_exoplanets-anthropic10,wisconsin_exoplanets-anthropic3710,wisconsin_exoplanets-geminipro10","1,5,3",0.8095238095238095,0.6909115309144422,0.8975157564061429,63,51,0.7272727272727273,0.6036427957562946,0.8296733838204806,66,48,12,18,2,4,39,30,10,14
"wisconsin_exoplanets-geminipro10,wisconsin_exoplanets-openaio1,wisconsin_exoplanets-phi","3,2,1",0.8095238095238095,0.6909115309144422,0.8975157564061429,63,51,0.6060606060606061,0.47809031269657515,0.7241907640463761,66,40,11,8,1,2,40,32,11,24
"wisconsin_exoplanets-geminipro10,wisconsin_exoplanets-openailong,wisconsin_exoplanets-openaio1","3,4,2",0.8095238095238095,0.6909115309144422,0.8975157564061429,63,51,0.6666666666666666,0.5398613431497497,0.7779692372780057,66,44,18,18,8,8,33,26,4,14
"wisconsin_exoplanets-geminipro,wisconsin_exoplanets-openai45,wisconsin_exoplanets-openai4510","2,4,2",0.8095238095238095,0.6909115309144422,0.8975157564061429,63,51,0.7121212121212122,0.5874932401392494,0.816959774581892,66,47,12,15,2,2,39,32,10,17
"wisconsin_exoplanets-geminipro,wisconsin_exoplanets-openai4510,wisconsin_exoplanets-openailong","2,2,4",0.8095238095238095,0.6909115309144422,0.8975157564061429,63,51,0.7121212121212122,0.5874932401392494,0.816959774581892,66,47,12,15,2,2,39,32,10,17
"wisconsin_exoplanets-geminipro,wisconsin_exoplanets-openai4510,wisconsin_exoplanets-openaio1","2,2,2",0.8095238095238095,0.6909115309144422,0.8975157564061429,63,51,0.5909090909090909,0.46293656355858825,0.7104508976039902,66,39,10,5,0,0,41,34,12,27
"wisconsin_exoplanets-geminipro10,wisconsin_exoplanets-openai10,wisconsin_exoplanets-openai4510","3,5,2",0.8095238095238095,0.6909115309144422,0.8975157564061429,63,51,0.7575757575757576,0.6363888076622838,0.8546316735018541,66,50,13,18,3,2,38,32,9,14
"wisconsin_exoplanets-geminipro10,wisconsin_exoplanets-llamaphi,wisconsin_exoplanets-openai4510","3,1,2",0.8095238095238095,0.6909115309144422,0.8975157564061429,63,51,0.7272727272727273,0.6036427957562946,0.8296733838204806,66,48,13,16,3,2,38,32,9,16
"wisconsin_exoplanets-anthropic,wisconsin_exoplanets-gemini10,wisconsin_exoplanets-llama","2,2,2",0.8095238095238095,0.6909115309144422,0.8975157564061429,63,51,0.803030303030303,0.6867611541519056,0.8907397343822825,66,53,13,21,3,2,38,32,9,11
"wisconsin_exoplanets-geminipro,wisconsin_exoplanets-openaio1,wisconsin_exoplanets-phi","2,2,1",0.8095238095238095,0.6909115309144422,0.8975157564061429,63,51,0.5757575757575758,0.4478940377087594,0.6965980669616616,66,38,11,6,1,2,40,32,11,26
"wisconsin_exoplanets-anthropic,wisconsin_exoplanets-openai,wisconsin_exoplanets-openai45","2,6,4",0.7936507936507936,0.6730266705316862,0.8852977866837404,63,50,0.8484848484848485,0.7389589287110891,0.9248753700606944,66,56,19,27,10,5,31,29,3,5
"wisconsin_exoplanets-gemini10,wisconsin_exoplanets-openai10o1,wisconsin_exoplanets-openai4510","2,5,2",0.7936507936507936,0.6730266705316862,0.8852977866837404,63,50,0.7878787878787878,0.6697885403521799,0.8788980677448571,66,52,10,19,1,1,40,33,12,13
"wisconsin_exoplanets-gemini,wisconsin_exoplanets-geminipro10,wisconsin_exoplanets-phi","7,3,1",0.7936507936507936,0.6730266705316862,0.8852977866837404,63,50,0.6060606060606061,0.47809031269657515,0.7241907640463761,66,40,11,10,2,4,39,30,11,22
"wisconsin_exoplanets-gemini,wisconsin_exoplanets-geminipro10,wisconsin_exoplanets-openaio1","7,3,2",0.7936507936507936,0.6730266705316862,0.8852977866837404,63,50,0.6666666666666666,0.5398613431497497,0.7779692372780057,66,44,14,14,5,4,36,30,8,18
"wisconsin_exoplanets-gemini,wisconsin_exoplanets-openai10,wisconsin_exoplanets-openaio1","7,5,2",0.7936507936507936,0.6730266705316862,0.8852977866837404,63,50,0.6363636363636364,0.5087394315103153,0.7513222169426668,66,42,20,22,11,14,30,20,2,10
"wisconsin_exoplanets-anthropic10,wisconsin_exoplanets-anthropic37,wisconsin_exoplanets-geminipro10","1,2,3",0.7936507936507936,0.6730266705316862,0.8852977866837404,63,50,0.6363636363636364,0.5087394315103153,0.7513222169426668,66,42,12,17,3,9,38,25,10,15
"wisconsin_exoplanets-falcon10,wisconsin_exoplanets-gemini10,wisconsin_exoplanets-openaio1","1,2,2",0.7936507936507936,0.6730266705316862,0.8852977866837404,63,50,0.6666666666666666,0.5398613431497497,0.7779692372780057,66,44,13,14,4,4,37,30,9,18
"wisconsin_exoplanets-anthropic37,wisconsin_exoplanets-falcon,wisconsin_exoplanets-gemini","2,1,7",0.7936507936507936,0.6730266705316862,0.8852977866837404,63,50,0.696969696969697,0.5714834854226349,0.8041003533935258,66,46,18,23,9,11,32,23,4,9
"wisconsin_exoplanets-anthropic37,wisconsin_exoplanets-openai4510,wisconsin_exoplanets-qwq","2,2,1",0.7936507936507936,0.6730266705316862,0.8852977866837404,63,50,0.7272727272727273,0.6036427957562946,0.8296733838204806,66,48,13,20,4,6,37,28,9,12
"wisconsin_exoplanets-falcon10,wisconsin_exoplanets-geminipro10,wisconsin_exoplanets-openai4510","1,3,2",0.7936507936507936,0.6730266705316862,0.8852977866837404,63,50,0.6818181818181818,0.5556078292305275,0.7911016327585585,66,45,9,11,0,0,41,34,13,21
"wisconsin_exoplanets-anthropic,wisconsin_exoplanets-openai10o1,wisconsin_exoplanets-openai45","2,5,4",0.7936507936507936,0.6730266705316862,0.8852977866837404,63,50,0.8484848484848485,0.7389589287110891,0.9248753700606944,66,56,18,27,9,5,32,29,4,5
"wisconsin_exoplanets-anthropic3710,wisconsin_exoplanets-deepseek,wisconsin_exoplanets-geminipro","5,1,2",0.7936507936507936,0.6730266705316862,0.8852977866837404,63,50,0.7727272727272727,0.6530018980228203,0.8668572164845951,66,51,11,21,2,4,39,30,11,11
"wisconsin_exoplanets-anthropic,wisconsin_exoplanets-openai10,wisconsin_exoplanets-openailong","2,5,4",0.7936507936507936,0.6730266705316862,0.8852977866837404,63,50,0.8484848484848485,0.7389589287110891,0.9248753700606944,66,56,17,27,8,5,33,29,5,5
"wisconsin_exoplanets-falcon10,wisconsin_exoplanets-geminipro10,wisconsin_exoplanets-openaio1","1,3,2",0.7936507936507936,0.6730266705316862,0.8852977866837404,63,50,0.6818181818181818,0.5556078292305275,0.7911016327585585,66,45,13,15,4,4,37,30,9,17
"wisconsin_exoplanets-gemini10,wisconsin_exoplanets-llama,wisconsin_exoplanets-openaio1","2,2,2",0.7936507936507936,0.6730266705316862,0.8852977866837404,63,50,0.6666666666666666,0.5398613431497497,0.7779692372780057,66,44,14,14,5,4,36,30,8,18
"wisconsin_exoplanets-anthropic,wisconsin_exoplanets-anthropic10,wisconsin_exoplanets-openaio1","2,1,2",0.7936507936507936,0.6730266705316862,0.8852977866837404,63,50,0.696969696969697,0.5714834854226349,0.8041003533935258,66,46,19,20,10,8,31,26,3,12
"wisconsin_exoplanets-anthropic,wisconsin_exoplanets-openai,wisconsin_exoplanets-openai10o1","2,6,5",0.7936507936507936,0.6730266705316862,0.8852977866837404,63,50,0.8333333333333334,0.7213265468376222,0.9137520659512851,66,55,18,26,9,5,32,29,4,6
"wisconsin_exoplanets-anthropic,wisconsin_exoplanets-openai,wisconsin_exoplanets-openai10","2,6,5",0.7936507936507936,0.6730266705316862,0.8852977866837404,63,50,0.8636363636363636,0.7568586684861609,0.9357018153567447,66,57,18,28,9,5,32,29,4,4
"wisconsin_exoplanets-geminipro,wisconsin_exoplanets-llamaphi,wisconsin_exoplanets-openai4510","2,1,2",0.7936507936507936,0.6730266705316862,0.8852977866837404,63,50,0.6818181818181818,0.5556078292305275,0.7911016327585585,66,45,11,13,2,2,39,32,11,19
"wisconsin_exoplanets-gemini,wisconsin_exoplanets-openai,wisconsin_exoplanets-openaio1","7,6,2",0.7936507936507936,0.6730266705316862,0.8852977866837404,63,50,0.6818181818181818,0.5556078292305275,0.7911016327585585,66,45,20,22,11,11,30,23,2,10
"wisconsin_exoplanets-geminipro,wisconsin_exoplanets-openai10,wisconsin_exoplanets-openai4510","2,5,2",0.7936507936507936,0.6730266705316862,0.8852977866837404,63,50,0.7121212121212122,0.5874932401392494,0.816959774581892,66,47,11,15,2,2,39,32,11,17
"wisconsin_exoplanets-anthropic,wisconsin_exoplanets-llamaphi,wisconsin_exoplanets-openailong","2,1,4",0.7936507936507936,0.6730266705316862,0.8852977866837404,63,50,0.8333333333333334,0.7213265468376222,0.9137520659512851,66,55,19,28,10,7,31,27,3,4
"wisconsin_exoplanets-geminipro,wisconsin_exoplanets-openai10o1,wisconsin_exoplanets-openai4510","2,5,2",0.7936507936507936,0.6730266705316862,0.8852977866837404,63,50,0.696969696969697,0.5714834854226349,0.8041003533935258,66,46,11,14,2,2,39,32,11,18
"wisconsin_exoplanets-anthropic37,wisconsin_exoplanets-gemini,wisconsin_exoplanets-openai10","2,7,5",0.7936507936507936,0.6730266705316862,0.8852977866837404,63,50,0.7424242424242424,0.6199387593265298,0.8422336207426879,66,49,22,32,13,17,28,17,0,0
"wisconsin_exoplanets-geminipro10,wisconsin_exoplanets-llama,wisconsin_exoplanets-openaio1","3,2,2",0.7936507936507936,0.6730266705316862,0.8852977866837404,63,50,0.6515151515151515,0.5242397683271001,0.7647080305896783,66,43,14,13,5,4,36,30,8,19
"wisconsin_exoplanets-deepseek,wisconsin_exoplanets-geminipro,wisconsin_exoplanets-openaio1","1,2,2",0.7936507936507936,0.6730266705316862,0.8852977866837404,63,50,0.7272727272727273,0.6036427957562946,0.8296733838204806,66,48,12,16,3,2,38,32,10,16
"wisconsin_exoplanets-anthropic37,wisconsin_exoplanets-gemini10,wisconsin_exoplanets-phi","2,2,1",0.7936507936507936,0.6730266705316862,0.8852977866837404,63,50,0.7121212121212122,0.5874932401392494,0.816959774581892,66,47,13,20,4,7,37,27,9,12
"wisconsin_exoplanets-anthropic,wisconsin_exoplanets-anthropic10,wisconsin_exoplanets-gemini","2,1,7",0.7936507936507936,0.6730266705316862,0.8852977866837404,63,50,0.7272727272727273,0.6036427957562946,0.8296733838204806,66,48,16,22,7,8,34,26,6,10
"wisconsin_exoplanets-geminipro10,wisconsin_exoplanets-openai10,wisconsin_exoplanets-openaio1","3,5,2",0.7936507936507936,0.6730266705316862,0.8852977866837404,63,50,0.6666666666666666,0.5398613431497497,0.7779692372780057,66,44,17,18,8,8,33,26,5,14
"wisconsin_exoplanets-deepseek,wisconsin_exoplanets-geminipro10,wisconsin_exoplanets-openai4510","1,3,2",0.7936507936507936,0.6730266705316862,0.8852977866837404,63,50,0.6515151515151515,0.5242397683271001,0.7647080305896783,66,43,9,10,0,1,41,33,13,22
"wisconsin_exoplanets-geminipro10,wisconsin_exoplanets-openai10o1,wisconsin_exoplanets-openai4510","3,5,2",0.7936507936507936,0.6730266705316862,0.8852977866837404,63,50,0.7424242424242424,0.6199387593265298,0.8422336207426879,66,49,12,17,3,2,38,32,10,15
"wisconsin_exoplanets-anthropic37,wisconsin_exoplanets-geminipro,wisconsin_exoplanets-phi","2,2,1",0.7936507936507936,0.6730266705316862,0.8852977866837404,63,50,0.6212121212121212,0.4933571772023376,0.7378154230046878,66,41,13,14,4,7,37,27,9,18
"wisconsin_exoplanets-deepseek,wisconsin_exoplanets-gemini10,wisconsin_exoplanets-openai4510","1,2,2",0.7936507936507936,0.6730266705316862,0.8852977866837404,63,50,0.7272727272727273,0.6036427957562946,0.8296733838204806,66,48,9,14,0,0,41,34,13,18
"wisconsin_exoplanets-gemini,wisconsin_exoplanets-llamaphi,wisconsin_exoplanets-openaio1","7,1,2",0.7936507936507936,0.6730266705316862,0.8852977866837404,63,50,0.6515151515151515,0.5242397683271001,0.7647080305896783,66,43,20,21,11,12,30,22,2,11
"wisconsin_exoplanets-geminipro10,wisconsin_exoplanets-openaio1,wisconsin_exoplanets-qwq","3,2,1",0.7936507936507936,0.6730266705316862,0.8852977866837404,63,50,0.6363636363636364,0.5087394315103153,0.7513222169426668,66,42,13,11,4,3,37,31,9,21
"wisconsin_exoplanets-anthropic37,wisconsin_exoplanets-geminipro10,wisconsin_exoplanets-phi","2,3,1",0.7936507936507936,0.6730266705316862,0.8852977866837404,63,50,0.6515151515151515,0.5242397683271001,0.7647080305896783,66,43,13,16,4,7,37,27,9,16
"wisconsin_exoplanets-gemini,wisconsin_exoplanets-llamaphi,wisconsin_exoplanets-openai","7,1,6",0.7936507936507936,0.6730266705316862,0.8852977866837404,63,50,0.6666666666666666,0.5398613431497497,0.7779692372780057,66,44,16,18,7,8,34,26,6,14
"wisconsin_exoplanets-gemini,wisconsin_exoplanets-llama,wisconsin_exoplanets-openaio1","7,2,2",0.7936507936507936,0.6730266705316862,0.8852977866837404,63,50,0.7424242424242424,0.6199387593265298,0.8422336207426879,66,49,18,22,9,7,32,27,4,10
"wisconsin_exoplanets-anthropic37,wisconsin_exoplanets-falcon10,wisconsin_exoplanets-geminipro","2,1,2",0.7936507936507936,0.6730266705316862,0.8852977866837404,63,50,0.7121212121212122,0.5874932401392494,0.816959774581892,66,47,13,20,4,7,37,27,9,12
"wisconsin_exoplanets-gemini,wisconsin_exoplanets-llama,wisconsin_exoplanets-openai4510","7,2,2",0.7936507936507936,0.6730266705316862,0.8852977866837404,63,50,0.696969696969697,0.5714834854226349,0.8041003533935258,66,46,13,17,4,5,37,29,9,15
"wisconsin_exoplanets-anthropic3710,wisconsin_exoplanets-falcon10,wisconsin_exoplanets-llama","5,1,2",0.7936507936507936,0.6730266705316862,0.8852977866837404,63,50,0.6818181818181818,0.5556078292305275,0.7911016327585585,66,45,19,26,10,15,31,19,3,6
"wisconsin_exoplanets-anthropic,wisconsin_exoplanets-llamaphi,wisconsin_exoplanets-openai","2,1,6",0.7936507936507936,0.6730266705316862,0.8852977866837404,63,50,0.8181818181818182,0.7039345441700697,0.9023647979841516,66,54,18,25,9,5,32,29,4,7
"wisconsin_exoplanets-anthropic,wisconsin_exoplanets-geminipro,wisconsin_exoplanets-llama","2,2,2",0.7936507936507936,0.6730266705316862,0.8852977866837404,63,50,0.7727272727272727,0.6530018980228203,0.8668572164845951,66,51,12,19,3,2,38,32,10,13
"wisconsin_exoplanets-anthropic,wisconsin_exoplanets-deepseek,wisconsin_exoplanets-gemini10","2,1,2",0.7936507936507936,0.6730266705316862,0.8852977866837404,63,50,0.8181818181818182,0.7039345441700697,0.9023647979841516,66,54,12,20,3,0,38,34,10,12
"wisconsin_exoplanets-anthropic,wisconsin_exoplanets-geminipro10,wisconsin_exoplanets-llama","2,3,2",0.7936507936507936,0.6730266705316862,0.8852977866837404,63,50,0.7878787878787878,0.6697885403521799,0.8788980677448571,66,52,13,20,4,2,37,32,9,12
"wisconsin_exoplanets-anthropic3710,wisconsin_exoplanets-gemini10,wisconsin_exoplanets-geminipro10","5,2,3",0.7936507936507936,0.6730266705316862,0.8852977866837404,63,50,0.696969696969697,0.5714834854226349,0.8041003533935258,66,46,9,12,0,0,41,34,13,20
"wisconsin_exoplanets-gemini,wisconsin_exoplanets-openailong,wisconsin_exoplanets-openaio1","7,4,2",0.7936507936507936,0.6730266705316862,0.8852977866837404,63,50,0.6363636363636364,0.5087394315103153,0.7513222169426668,66,42,20,22,11,14,30,20,2,10
"wisconsin_exoplanets-anthropic,wisconsin_exoplanets-geminipro,wisconsin_exoplanets-openai10","2,2,5",0.7936507936507936,0.6730266705316862,0.8852977866837404,63,50,0.8181818181818182,0.7039345441700697,0.9023647979841516,66,54,17,26,8,6,33,28,5,6
"wisconsin_exoplanets-anthropic,wisconsin_exoplanets-gemini,wisconsin_exoplanets-phi","2,7,1",0.7936507936507936,0.6730266705316862,0.8852977866837404,63,50,0.7272727272727273,0.6036427957562946,0.8296733838204806,66,48,15,20,6,6,35,28,7,12
"wisconsin_exoplanets-anthropic,wisconsin_exoplanets-geminipro10,wisconsin_exoplanets-openai10o1","2,3,5",0.7936507936507936,0.6730266705316862,0.8852977866837404,63,50,0.803030303030303,0.6867611541519056,0.8907397343822825,66,53,18,25,9,6,32,28,4,7
"wisconsin_exoplanets-anthropic,wisconsin_exoplanets-geminipro,wisconsin_exoplanets-openai","2,2,6",0.7936507936507936,0.6730266705316862,0.8852977866837404,63,50,0.803030303030303,0.6867611541519056,0.8907397343822825,66,53,18,25,9,6,32,28,4,7
"wisconsin_exoplanets-gemini,wisconsin_exoplanets-openai45,wisconsin_exoplanets-openaio1","7,4,2",0.7936507936507936,0.6730266705316862,0.8852977866837404,63,50,0.6363636363636364,0.5087394315103153,0.7513222169426668,66,42,20,22,11,14,30,20,2,10
"wisconsin_exoplanets-anthropic,wisconsin_exoplanets-geminipro10,wisconsin_exoplanets-openai4510","2,3,2",0.7936507936507936,0.6730266705316862,0.8852977866837404,63,50,0.7575757575757576,0.6363888076622838,0.8546316735018541,66,50,10,16,1,0,40,34,12,16
"wisconsin_exoplanets-anthropic,wisconsin_exoplanets-falcon10,wisconsin_exoplanets-openaio1","2,1,2",0.7936507936507936,0.6730266705316862,0.8852977866837404,63,50,0.7575757575757576,0.6363888076622838,0.8546316735018541,66,50,20,24,11,8,30,26,2,8
"wisconsin_exoplanets-anthropic,wisconsin_exoplanets-geminipro,wisconsin_exoplanets-openai10o1","2,2,5",0.7936507936507936,0.6730266705316862,0.8852977866837404,63,50,0.803030303030303,0.6867611541519056,0.8907397343822825,66,53,17,25,8,6,33,28,5,7
"wisconsin_exoplanets-anthropic,wisconsin_exoplanets-geminipro10,wisconsin_exoplanets-openailong","2,3,4",0.7936507936507936,0.6730266705316862,0.8852977866837404,63,50,0.8181818181818182,0.7039345441700697,0.9023647979841516,66,54,17,26,8,6,33,28,5,6
"wisconsin_exoplanets-gemini,wisconsin_exoplanets-gemini10,wisconsin_exoplanets-llama","7,2,2",0.7936507936507936,0.6730266705316862,0.8852977866837404,63,50,0.696969696969697,0.5714834854226349,0.8041003533935258,66,46,12,16,3,4,38,30,10,16
"wisconsin_exoplanets-anthropic,wisconsin_exoplanets-gemini10,wisconsin_exoplanets-llamaphi","2,2,1",0.7936507936507936,0.6730266705316862,0.8852977866837404,63,50,0.8181818181818182,0.7039345441700697,0.9023647979841516,66,54,18,25,9,5,32,29,4,7
"wisconsin_exoplanets-gemini10,wisconsin_exoplanets-geminipro10,wisconsin_exoplanets-openaio1","2,3,2",0.7936507936507936,0.6730266705316862,0.8852977866837404,63,50,0.696969696969697,0.5714834854226349,0.8041003533935258,66,46,9,12,0,0,41,34,13,20
"wisconsin_exoplanets-anthropic,wisconsin_exoplanets-gemini10,wisconsin_exoplanets-openai","2,2,6",0.7936507936507936,0.6730266705316862,0.8852977866837404,63,50,0.8181818181818182,0.7039345441700697,0.9023647979841516,66,54,18,25,9,5,32,29,4,7
"wisconsin_exoplanets-anthropic3710,wisconsin_exoplanets-gemini,wisconsin_exoplanets-geminipro10","5,7,3",0.7936507936507936,0.6730266705316862,0.8852977866837404,63,50,0.6818181818181818,0.5556078292305275,0.7911016327585585,66,45,12,16,3,5,38,29,10,16
"wisconsin_exoplanets-anthropic,wisconsin_exoplanets-falcon10,wisconsin_exoplanets-gemini","2,1,7",0.7936507936507936,0.6730266705316862,0.8852977866837404,63,50,0.7575757575757576,0.6363888076622838,0.8546316735018541,66,50,17,23,8,7,33,27,5,9
"wisconsin_exoplanets-anthropic,wisconsin_exoplanets-gemini10,wisconsin_exoplanets-openai10","2,2,5",0.7936507936507936,0.6730266705316862,0.8852977866837404,63,50,0.8333333333333334,0.7213265468376222,0.9137520659512851,66,55,17,26,8,5,33,29,5,6
"wisconsin_exoplanets-anthropic,wisconsin_exoplanets-falcon,wisconsin_exoplanets-openaio1","2,1,2",0.7936507936507936,0.6730266705316862,0.8852977866837404,63,50,0.6818181818181818,0.5556078292305275,0.7911016327585585,66,45,19,19,10,8,31,26,3,13
"wisconsin_exoplanets-openai45,wisconsin_exoplanets-openailong,wisconsin_exoplanets-qwq","4,4,1",0.7924528301886793,0.6589286330507328,0.8915771767140479,53,42,0.7714285714285715,0.6555249905543887,0.8633430194237376,70,54,19,20,8,12,23,34,3,4
"wisconsin_exoplanets-openai10o1,wisconsin_exoplanets-openai45,wisconsin_exoplanets-openaio1","5,4,2",0.7924528301886793,0.6589286330507328,0.8915771767140479,53,42,0.6909090909090909,0.5518702546562255,0.8085535885663784,55,38,16,8,3,4,26,30,8,13
"wisconsin_exoplanets-openai10o1,wisconsin_exoplanets-openailong,wisconsin_exoplanets-openaio1","5,4,2",0.7924528301886793,0.6589286330507328,0.8915771767140479,53,42,0.7090909090909091,0.5710174174438851,0.8237003426417631,55,39,15,8,2,3,27,31,9,13
"wisconsin_exoplanets-openai10,wisconsin_exoplanets-openai45,wisconsin_exoplanets-phi","5,4,1",0.7924528301886793,0.6589286330507328,0.8915771767140479,53,42,0.7285714285714285,0.6090202122941876,0.8280088362003184,70,51,21,20,10,15,21,31,1,4
"wisconsin_exoplanets-openai10,wisconsin_exoplanets-openai45,wisconsin_exoplanets-qwq","5,4,1",0.7924528301886793,0.6589286330507328,0.8915771767140479,53,42,0.7285714285714285,0.6090202122941876,0.8280088362003184,70,51,21,20,10,15,21,31,1,4
"wisconsin_exoplanets-openai10,wisconsin_exoplanets-openai45,wisconsin_exoplanets-openai4510","5,4,2",0.7924528301886793,0.6589286330507328,0.8915771767140479,53,42,0.7428571428571429,0.6243856142763229,0.8399301090675972,70,52,20,20,9,14,22,32,2,4
"wisconsin_exoplanets-openai45,wisconsin_exoplanets-openailong,wisconsin_exoplanets-openaio1","4,4,2",0.7924528301886793,0.6589286330507328,0.8915771767140479,53,42,0.7857142857142857,0.6713148547210506,0.874816428507753,70,55,19,20,8,11,23,35,3,4
"wisconsin_exoplanets-openai10o1,wisconsin_exoplanets-openai4510,wisconsin_exoplanets-openailong","5,2,4",0.7924528301886793,0.6589286330507328,0.8915771767140479,53,42,0.6909090909090909,0.5518702546562255,0.8085535885663784,55,38,14,6,1,2,28,32,10,15
"wisconsin_exoplanets-openai10o1,wisconsin_exoplanets-openai45,wisconsin_exoplanets-openai4510","5,4,2",0.7924528301886793,0.6589286330507328,0.8915771767140479,53,42,0.6727272727272727,0.532928951764585,0.7931918831325926,55,37,15,6,2,3,27,31,9,15
"wisconsin_exoplanets-deepseek,wisconsin_exoplanets-gemini,wisconsin_exoplanets-geminipro10","1,7,3",0.7777777777777778,0.6553558462956381,0.8728492567468735,63,49,0.6818181818181818,0.5556078292305275,0.7911016327585585,66,45,11,16,3,5,38,29,11,16
"wisconsin_exoplanets-geminipro10,wisconsin_exoplanets-openai4510,wisconsin_exoplanets-phi","3,2,1",0.7777777777777778,0.6553558462956381,0.8728492567468735,63,49,0.6666666666666666,0.5398613431497497,0.7779692372780057,66,44,9,11,1,1,40,33,13,21
"wisconsin_exoplanets-anthropic,wisconsin_exoplanets-gemini,wisconsin_exoplanets-qwq","2,7,1",0.7777777777777778,0.6553558462956381,0.8728492567468735,63,49,0.7424242424242424,0.6199387593265298,0.8422336207426879,66,49,17,20,9,5,32,29,5,12
"wisconsin_exoplanets-deepseek,wisconsin_exoplanets-gemini,wisconsin_exoplanets-geminipro","1,7,2",0.7777777777777778,0.6553558462956381,0.8728492567468735,63,49,0.6666666666666666,0.5398613431497497,0.7779692372780057,66,44,10,15,2,5,39,29,12,17
"wisconsin_exoplanets-anthropic3710,wisconsin_exoplanets-geminipro10,wisconsin_exoplanets-qwq","5,3,1",0.7777777777777778,0.6553558462956381,0.8728492567468735,63,49,0.6818181818181818,0.5556078292305275,0.7911016327585585,66,45,11,13,3,2,38,32,11,19
"wisconsin_exoplanets-anthropic,wisconsin_exoplanets-gemini10,wisconsin_exoplanets-geminipro10","2,2,3",0.7777777777777778,0.6553558462956381,0.8728492567468735,63,49,0.696969696969697,0.5714834854226349,0.8041003533935258,66,46,9,12,1,0,40,34,13,20
"wisconsin_exoplanets-anthropic37,wisconsin_exoplanets-geminipro10,wisconsin_exoplanets-qwq","2,3,1",0.7777777777777778,0.6553558462956381,0.8728492567468735,63,49,0.6515151515151515,0.5242397683271001,0.7647080305896783,66,43,12,14,4,5,37,29,10,18
"wisconsin_exoplanets-gemini,wisconsin_exoplanets-gemini10,wisconsin_exoplanets-openai","7,2,6",0.7777777777777778,0.6553558462956381,0.8728492567468735,63,49,0.6818181818181818,0.5556078292305275,0.7911016327585585,66,45,15,19,7,8,34,26,7,13
"wisconsin_exoplanets-anthropic37,wisconsin_exoplanets-gemini10,wisconsin_exoplanets-geminipro10","2,2,3",0.7777777777777778,0.6553558462956381,0.8728492567468735,63,49,0.696969696969697,0.5714834854226349,0.8041003533935258,66,46,8,12,0,0,41,34,14,20
"wisconsin_exoplanets-openai4510,wisconsin_exoplanets-openaio1,wisconsin_exoplanets-qwq","2,2,1",0.7777777777777778,0.6553558462956381,0.8728492567468735,63,49,0.6363636363636364,0.5087394315103153,0.7513222169426668,66,42,11,11,3,3,38,31,11,21
"wisconsin_exoplanets-anthropic,wisconsin_exoplanets-llamaphi,wisconsin_exoplanets-openai10","2,1,5",0.7777777777777778,0.6553558462956381,0.8728492567468735,63,49,0.8484848484848485,0.7389589287110891,0.9248753700606944,66,56,18,29,10,7,31,27,4,3
"wisconsin_exoplanets-falcon10,wisconsin_exoplanets-gemini,wisconsin_exoplanets-gemini10","1,7,2",0.7777777777777778,0.6553558462956381,0.8728492567468735,63,49,0.6818181818181818,0.5556078292305275,0.7911016327585585,66,45,11,16,3,5,38,29,11,16
"wisconsin_exoplanets-anthropic,wisconsin_exoplanets-gemini10,wisconsin_exoplanets-openai4510","2,2,2",0.7777777777777778,0.6553558462956381,0.8728492567468735,63,49,0.7878787878787878,0.6697885403521799,0.8788980677448571,66,52,8,18,0,0,41,34,14,14
"wisconsin_exoplanets-anthropic,wisconsin_exoplanets-llamaphi,wisconsin_exoplanets-openai45","2,1,4",0.7777777777777778,0.6553558462956381,0.8728492567468735,63,49,0.8333333333333334,0.7213265468376222,0.9137520659512851,66,55,19,28,11,7,30,27,3,4
"wisconsin_exoplanets-geminipro10,wisconsin_exoplanets-gemma,wisconsin_exoplanets-openai4510","3,1,2",0.7777777777777778,0.6553558462956381,0.8728492567468735,63,49,0.5757575757575758,0.4478940377087594,0.6965980669616616,66,38,8,6,0,2,41,32,14,26
"wisconsin_exoplanets-gemini,wisconsin_exoplanets-geminipro,wisconsin_exoplanets-llama","7,2,2",0.7777777777777778,0.6553558462956381,0.8728492567468735,63,49,0.6060606060606061,0.47809031269657515,0.7241907640463761,66,40,11,11,3,5,38,29,11,21
"wisconsin_exoplanets-gemini,wisconsin_exoplanets-geminipro,wisconsin_exoplanets-openai","7,2,6",0.7777777777777778,0.6553558462956381,0.8728492567468735,63,49,0.6363636363636364,0.5087394315103153,0.7513222169426668,66,42,15,16,7,8,34,26,7,16
"wisconsin_exoplanets-anthropic,wisconsin_exoplanets-llamaphi,wisconsin_exoplanets-openaio1","2,1,2",0.7777777777777778,0.6553558462956381,0.8728492567468735,63,49,0.7878787878787878,0.6697885403521799,0.8788980677448571,66,52,20,27,12,9,29,25,2,5
"wisconsin_exoplanets-anthropic3710,wisconsin_exoplanets-falcon10,wisconsin_exoplanets-geminipro","5,1,2",0.7777777777777778,0.6553558462956381,0.8728492567468735,63,49,0.7575757575757576,0.6363888076622838,0.8546316735018541,66,50,12,20,4,4,37,30,10,12
"wisconsin_exoplanets-gemini,wisconsin_exoplanets-gemini10,wisconsin_exoplanets-llamaphi","7,2,1",0.7777777777777778,0.6553558462956381,0.8728492567468735,63,49,0.6818181818181818,0.5556078292305275,0.7911016327585585,66,45,15,19,7,8,34,26,7,13
"wisconsin_exoplanets-anthropic3710,wisconsin_exoplanets-falcon,wisconsin_exoplanets-openai4510","5,1,2",0.7777777777777778,0.6553558462956381,0.8728492567468735,63,49,0.7121212121212122,0.5874932401392494,0.816959774581892,66,47,11,16,3,3,38,31,11,16
"wisconsin_exoplanets-anthropic,wisconsin_exoplanets-openai,wisconsin_exoplanets-openaio1","2,6,2",0.7777777777777778,0.6553558462956381,0.8728492567468735,63,49,0.7878787878787878,0.6697885403521799,0.8788980677448571,66,52,20,26,12,8,29,26,2,6
"wisconsin_exoplanets-anthropic3710,wisconsin_exoplanets-openai4510,wisconsin_exoplanets-qwq","5,2,1",0.7777777777777778,0.6553558462956381,0.8728492567468735,63,49,0.7727272727272727,0.6530018980228203,0.8668572164845951,66,51,10,19,2,2,39,32,12,13
"wisconsin_exoplanets-anthropic,wisconsin_exoplanets-geminipro10,wisconsin_exoplanets-openai10","2,3,5",0.7777777777777778,0.6553558462956381,0.8728492567468735,63,49,0.8181818181818182,0.7039345441700697,0.9023647979841516,66,54,17,26,9,6,32,28,5,6
"wisconsin_exoplanets-anthropic3710,wisconsin_exoplanets-deepseek,wisconsin_exoplanets-openai","5,1,6",0.7777777777777778,0.6553558462956381,0.8728492567468735,63,49,0.6818181818181818,0.5556078292305275,0.7911016327585585,66,45,22,29,14,18,27,16,0,3
"wisconsin_exoplanets-anthropic,wisconsin_exoplanets-geminipro10,wisconsin_exoplanets-openai","2,3,6",0.7777777777777778,0.6553558462956381,0.8728492567468735,63,49,0.803030303030303,0.6867611541519056,0.8907397343822825,66,53,18,25,10,6,31,28,4,7
"wisconsin_exoplanets-gemini,wisconsin_exoplanets-geminipro10,wisconsin_exoplanets-openai","7,3,6",0.7777777777777778,0.6553558462956381,0.8728492567468735,63,49,0.6515151515151515,0.5242397683271001,0.7647080305896783,66,43,15,17,7,8,34,26,7,15
"wisconsin_exoplanets-anthropic10,wisconsin_exoplanets-anthropic37,wisconsin_exoplanets-gemini10","1,2,2",0.7777777777777778,0.6553558462956381,0.8728492567468735,63,49,0.6515151515151515,0.5242397683271001,0.7647080305896783,66,43,10,17,2,8,39,26,12,15
"wisconsin_exoplanets-anthropic10,wisconsin_exoplanets-anthropic37,wisconsin_exoplanets-llama","1,2,2",0.7777777777777778,0.6553558462956381,0.8728492567468735,63,49,0.6666666666666666,0.5398613431497497,0.7779692372780057,66,44,17,24,9,14,32,20,5,8
"wisconsin_exoplanets-anthropic,wisconsin_exoplanets-geminipro,wisconsin_exoplanets-llamaphi","2,2,1",0.7777777777777778,0.6553558462956381,0.8728492567468735,63,49,0.7878787878787878,0.6697885403521799,0.8788980677448571,66,52,17,24,9,6,32,28,5,8
"wisconsin_exoplanets-anthropic,wisconsin_exoplanets-llamaphi,wisconsin_exoplanets-openai10o1","2,1,5",0.7777777777777778,0.6553558462956381,0.8728492567468735,63,49,0.8181818181818182,0.7039345441700697,0.9023647979841516,66,54,18,27,10,7,31,27,4,5
"wisconsin_exoplanets-anthropic10,wisconsin_exoplanets-anthropic3710,wisconsin_exoplanets-gemini","1,5,7",0.7777777777777778,0.6553558462956381,0.8728492567468735,63,49,0.7121212121212122,0.5874932401392494,0.816959774581892,66,47,14,23,6,10,35,24,8,9
"wisconsin_exoplanets-anthropic,wisconsin_exoplanets-deepseek,wisconsin_exoplanets-geminipro10","2,1,3",0.7777777777777778,0.6553558462956381,0.8728492567468735,63,49,0.803030303030303,0.6867611541519056,0.8907397343822825,66,53,12,20,4,1,37,33,10,12
"wisconsin_exoplanets-anthropic10,wisconsin_exoplanets-anthropic3710,wisconsin_exoplanets-geminipro","1,5,2",0.7777777777777778,0.6553558462956381,0.8728492567468735,63,49,0.7121212121212122,0.5874932401392494,0.816959774581892,66,47,10,17,2,4,39,30,12,15
"wisconsin_exoplanets-anthropic,wisconsin_exoplanets-anthropic10,wisconsin_exoplanets-openai4510","2,1,2",0.7777777777777778,0.6553558462956381,0.8728492567468735,63,49,0.7878787878787878,0.6697885403521799,0.8788980677448571,66,52,13,21,5,3,36,31,9,11
"wisconsin_exoplanets-deepseek,wisconsin_exoplanets-geminipro,wisconsin_exoplanets-openai4510","1,2,2",0.7777777777777778,0.6553558462956381,0.8728492567468735,63,49,0.6060606060606061,0.47809031269657515,0.7241907640463761,66,40,8,7,0,1,41,33,14,25
"wisconsin_exoplanets-gemini,wisconsin_exoplanets-openai,wisconsin_exoplanets-openai10o1","7,6,5",0.7777777777777778,0.6553558462956381,0.8728492567468735,63,49,0.6515151515151515,0.5242397683271001,0.7647080305896783,66,43,16,19,8,10,33,24,6,13
"wisconsin_exoplanets-anthropic10,wisconsin_exoplanets-geminipro10,wisconsin_exoplanets-openaio1","1,3,2",0.7777777777777778,0.6553558462956381,0.8728492567468735,63,49,0.6666666666666666,0.5398613431497497,0.7779692372780057,66,44,12,16,4,6,37,28,10,16
"wisconsin_exoplanets-anthropic37,wisconsin_exoplanets-falcon10,wisconsin_exoplanets-llama","2,1,2",0.7777777777777778,0.6553558462956381,0.8728492567468735,63,49,0.6818181818181818,0.5556078292305275,0.7911016327585585,66,45,19,26,11,15,30,19,3,6
"wisconsin_exoplanets-anthropic10,wisconsin_exoplanets-gemini,wisconsin_exoplanets-openaio1","1,7,2",0.7777777777777778,0.6553558462956381,0.8728492567468735,63,49,0.696969696969697,0.5714834854226349,0.8041003533935258,66,46,16,19,8,7,33,27,6,13
"wisconsin_exoplanets-anthropic37,wisconsin_exoplanets-falcon,wisconsin_exoplanets-openai4510","2,1,2",0.7777777777777778,0.6553558462956381,0.8728492567468735,63,49,0.7121212121212122,0.5874932401392494,0.816959774581892,66,47,13,18,5,5,36,29,9,14
"wisconsin_exoplanets-anthropic10,wisconsin_exoplanets-gemini10,wisconsin_exoplanets-openaio1","1,2,2",0.7777777777777778,0.6553558462956381,0.8728492567468735,63,49,0.6818181818181818,0.5556078292305275,0.7911016327585585,66,45,11,16,3,5,38,29,11,16
"wisconsin_exoplanets-anthropic37,wisconsin_exoplanets-deepseek,wisconsin_exoplanets-falcon10","2,1,1",0.7777777777777778,0.6553558462956381,0.8728492567468735,63,49,0.7878787878787878,0.6697885403521799,0.8788980677448571,66,52,18,28,10,10,31,24,4,4
"wisconsin_exoplanets-gemini,wisconsin_exoplanets-openai,wisconsin_exoplanets-openailong","7,6,4",0.7777777777777778,0.6553558462956381,0.8728492567468735,63,49,0.6666666666666666,0.5398613431497497,0.7779692372780057,66,44,16,20,8,10,33,24,6,12
"wisconsin_exoplanets-openai10o1,wisconsin_exoplanets-openaio1,wisconsin_exoplanets-phi","5,2,1",0.7735849056603774,0.6379040768369847,0.877172643417564,53,41,0.7090909090909091,0.5710174174438851,0.8237003426417631,55,39,13,7,1,2,28,32,11,14
"wisconsin_exoplanets-openai45,wisconsin_exoplanets-openailong,wisconsin_exoplanets-phi","4,4,1",0.7735849056603774,0.6379040768369847,0.877172643417564,53,41,0.7714285714285715,0.6555249905543887,0.8633430194237376,70,54,19,20,9,12,22,34,3,4
"wisconsin_exoplanets-openai45,wisconsin_exoplanets-openai4510,wisconsin_exoplanets-openailong","4,2,4",0.7735849056603774,0.6379040768369847,0.877172643417564,53,41,0.7857142857142857,0.6713148547210506,0.874816428507753,70,55,18,20,8,11,23,35,4,4
"wisconsin_exoplanets-openai10o1,wisconsin_exoplanets-openai45,wisconsin_exoplanets-openailong","5,4,4",0.7735849056603774,0.6379040768369847,0.877172643417564,53,41,0.6909090909090909,0.5518702546562255,0.8085535885663784,55,38,13,6,1,2,28,32,11,15
"wisconsin_exoplanets-openai10o1,wisconsin_exoplanets-phi,wisconsin_exoplanets-qwq","5,1,1",0.7735849056603774,0.6379040768369847,0.877172643417564,53,41,0.7090909090909091,0.5710174174438851,0.8237003426417631,55,39,13,6,1,1,28,33,11,15
"wisconsin_exoplanets-openai10o1,wisconsin_exoplanets-openaio1,wisconsin_exoplanets-qwq","5,2,1",0.7735849056603774,0.6379040768369847,0.877172643417564,53,41,0.6909090909090909,0.5518702546562255,0.8085535885663784,55,38,13,7,1,3,28,31,11,14
"wisconsin_exoplanets-anthropic10,wisconsin_exoplanets-anthropic37,wisconsin_exoplanets-gemma","1,2,1",0.7619047619047619,0.6378836219672017,0.8601883518609403,63,48,0.5454545454545454,0.4181368331466126,0.6685606183790747,66,36,17,20,10,18,31,16,5,12
"wisconsin_exoplanets-anthropic,wisconsin_exoplanets-gemini10,wisconsin_exoplanets-phi","2,2,1",0.7619047619047619,0.6378836219672017,0.8601883518609403,63,48,0.7727272727272727,0.6530018980228203,0.8668572164845951,66,51,11,19,4,2,37,32,11,13
"wisconsin_exoplanets-gemini10,wisconsin_exoplanets-openai4510,wisconsin_exoplanets-phi","2,2,1",0.7619047619047619,0.6378836219672017,0.8601883518609403,63,48,0.6666666666666666,0.5398613431497497,0.7779692372780057,66,44,8,11,1,1,40,33,14,21
"wisconsin_exoplanets-gemini,wisconsin_exoplanets-openai45,wisconsin_exoplanets-openailong","7,4,4",0.7619047619047619,0.6378836219672017,0.8601883518609403,63,48,0.6666666666666666,0.5398613431497497,0.7779692372780057,66,44,15,18,8,8,33,26,7,14
"wisconsin_exoplanets-anthropic,wisconsin_exoplanets-geminipro,wisconsin_exoplanets-gemma","2,2,1",0.7619047619047619,0.6378836219672017,0.8601883518609403,63,48,0.6363636363636364,0.5087394315103153,0.7513222169426668,66,42,12,10,5,2,36,32,10,22
"wisconsin_exoplanets-geminipro,wisconsin_exoplanets-openaio1,wisconsin_exoplanets-qwq","2,2,1",0.7619047619047619,0.6378836219672017,0.8601883518609403,63,48,0.6363636363636364,0.5087394315103153,0.7513222169426668,66,42,11,11,4,3,37,31,11,21
"wisconsin_exoplanets-anthropic,wisconsin_exoplanets-gemini10,wisconsin_exoplanets-gemma","2,2,1",0.7619047619047619,0.6378836219672017,0.8601883518609403,63,48,0.7121212121212122,0.5874932401392494,0.816959774581892,66,47,11,14,4,1,37,33,11,18
"wisconsin_exoplanets-gemini,wisconsin_exoplanets-geminipro10,wisconsin_exoplanets-openai4510","7,3,2",0.7619047619047619,0.6378836219672017,0.8601883518609403,63,48,0.6212121212121212,0.4933571772023376,0.7378154230046878,66,41,9,8,2,1,39,33,13,24
"wisconsin_exoplanets-gemini,wisconsin_exoplanets-openai,wisconsin_exoplanets-openai45","7,6,4",0.7619047619047619,0.6378836219672017,0.8601883518609403,63,48,0.6818181818181818,0.5556078292305275,0.7911016327585585,66,45,16,20,9,9,32,25,6,12
"wisconsin_exoplanets-anthropic10,wisconsin_exoplanets-anthropic3710,wisconsin_exoplanets-gemma","1,5,1",0.7619047619047619,0.6378836219672017,0.8601883518609403,63,48,0.6363636363636364,0.5087394315103153,0.7513222169426668,66,42,16,20,9,12,32,22,6,12
"wisconsin_exoplanets-anthropic10,wisconsin_exoplanets-anthropic3710,wisconsin_exoplanets-llama","1,5,2",0.7619047619047619,0.6378836219672017,0.8601883518609403,63,48,0.6515151515151515,0.5242397683271001,0.7647080305896783,66,43,14,25,7,16,34,18,8,7
"wisconsin_exoplanets-anthropic3710,wisconsin_exoplanets-gemma,wisconsin_exoplanets-llama","5,1,2",0.7619047619047619,0.6378836219672017,0.8601883518609403,63,48,0.6212121212121212,0.4933571772023376,0.7378154230046878,66,41,17,20,10,13,31,21,5,12
"wisconsin_exoplanets-gemini,wisconsin_exoplanets-gemini10,wisconsin_exoplanets-openai45","7,2,4",0.7619047619047619,0.6378836219672017,0.8601883518609403,63,48,0.696969696969697,0.5714834854226349,0.8041003533935258,66,46,15,20,8,8,33,26,7,12
"wisconsin_exoplanets-gemini10,wisconsin_exoplanets-geminipro,wisconsin_exoplanets-openaio1","2,2,2",0.7619047619047619,0.6378836219672017,0.8601883518609403,63,48,0.6666666666666666,0.5398613431497497,0.7779692372780057,66,44,7,10,0,0,41,34,15,22
"wisconsin_exoplanets-anthropic3710,wisconsin_exoplanets-gemma,wisconsin_exoplanets-phi","5,1,1",0.7619047619047619,0.6378836219672017,0.8601883518609403,63,48,0.6363636363636364,0.5087394315103153,0.7513222169426668,66,42,17,18,10,10,31,24,5,14
"wisconsin_exoplanets-gemini,wisconsin_exoplanets-openai10,wisconsin_exoplanets-openai45","7,5,4",0.7619047619047619,0.6378836219672017,0.8601883518609403,63,48,0.6666666666666666,0.5398613431497497,0.7779692372780057,66,44,15,18,8,8,33,26,7,14
"wisconsin_exoplanets-anthropic,wisconsin_exoplanets-geminipro,wisconsin_exoplanets-openai4510","2,2,2",0.7619047619047619,0.6378836219672017,0.8601883518609403,63,48,0.7121212121212122,0.5874932401392494,0.816959774581892,66,47,8,13,1,0,40,34,14,19
"wisconsin_exoplanets-anthropic10,wisconsin_exoplanets-anthropic37,wisconsin_exoplanets-geminipro","1,2,2",0.7619047619047619,0.6378836219672017,0.8601883518609403,63,48,0.6212121212121212,0.4933571772023376,0.7378154230046878,66,41,10,16,3,9,38,25,12,16
"wisconsin_exoplanets-geminipro,wisconsin_exoplanets-llama,wisconsin_exoplanets-openaio1","2,2,2",0.7619047619047619,0.6378836219672017,0.8601883518609403,63,48,0.6363636363636364,0.5087394315103153,0.7513222169426668,66,42,13,12,6,4,35,30,9,20
"wisconsin_exoplanets-anthropic3710,wisconsin_exoplanets-falcon,wisconsin_exoplanets-geminipro10","5,1,3",0.7619047619047619,0.6378836219672017,0.8601883518609403,63,48,0.7272727272727273,0.6036427957562946,0.8296733838204806,66,48,11,16,4,2,37,32,11,16
"wisconsin_exoplanets-gemini,wisconsin_exoplanets-geminipro,wisconsin_exoplanets-openai45","7,2,4",0.7619047619047619,0.6378836219672017,0.8601883518609403,63,48,0.6515151515151515,0.5242397683271001,0.7647080305896783,66,43,15,17,8,8,33,26,7,15
"wisconsin_exoplanets-gemini,wisconsin_exoplanets-geminipro10,wisconsin_exoplanets-llama","7,3,2",0.7619047619047619,0.6378836219672017,0.8601883518609403,63,48,0.6363636363636364,0.5087394315103153,0.7513222169426668,66,42,12,13,5,5,36,29,10,19
"wisconsin_exoplanets-anthropic3710,wisconsin_exoplanets-deepseek,wisconsin_exoplanets-phi","5,1,1",0.7619047619047619,0.6378836219672017,0.8601883518609403,63,48,0.7424242424242424,0.6199387593265298,0.8422336207426879,66,49,16,24,9,9,32,25,6,8
"wisconsin_exoplanets-anthropic3710,wisconsin_exoplanets-deepseek,wisconsin_exoplanets-openai45","5,1,4",0.7619047619047619,0.6378836219672017,0.8601883518609403,63,48,0.7121212121212122,0.5874932401392494,0.816959774581892,66,47,22,29,15,16,26,18,0,3
"wisconsin_exoplanets-anthropic3710,wisconsin_exoplanets-deepseek,wisconsin_exoplanets-openai10o1","5,1,5",0.7619047619047619,0.6378836219672017,0.8601883518609403,63,48,0.7121212121212122,0.5874932401392494,0.816959774581892,66,47,22,29,15,16,26,18,0,3
"wisconsin_exoplanets-gemini,wisconsin_exoplanets-openai10o1,wisconsin_exoplanets-openailong","7,5,4",0.7619047619047619,0.6378836219672017,0.8601883518609403,63,48,0.6212121212121212,0.4933571772023376,0.7378154230046878,66,41,15,18,8,11,33,23,7,14
"wisconsin_exoplanets-gemini,wisconsin_exoplanets-geminipro,wisconsin_exoplanets-llamaphi","7,2,1",0.7619047619047619,0.6378836219672017,0.8601883518609403,63,48,0.6515151515151515,0.5242397683271001,0.7647080305896783,66,43,14,17,7,8,34,26,8,15
"wisconsin_exoplanets-anthropic3710,wisconsin_exoplanets-deepseek,wisconsin_exoplanets-llamaphi","5,1,1",0.7619047619047619,0.6378836219672017,0.8601883518609403,63,48,0.6666666666666666,0.5398613431497497,0.7779692372780057,66,44,21,28,14,18,27,16,1,4
"wisconsin_exoplanets-anthropic3710,wisconsin_exoplanets-deepseek,wisconsin_exoplanets-llama","5,1,2",0.7619047619047619,0.6378836219672017,0.8601883518609403,63,48,0.696969696969697,0.5714834854226349,0.8041003533935258,66,46,17,25,10,13,31,21,5,7
"wisconsin_exoplanets-gemini,wisconsin_exoplanets-geminipro,wisconsin_exoplanets-gemma","7,2,1",0.7619047619047619,0.6378836219672017,0.8601883518609403,63,48,0.5303030303030303,0.403420053441725,0.654378697236779,66,35,11,6,4,5,37,29,11,26
"wisconsin_exoplanets-anthropic3710,wisconsin_exoplanets-falcon10,wisconsin_exoplanets-phi","5,1,1",0.7619047619047619,0.6378836219672017,0.8601883518609403,63,48,0.7424242424242424,0.6199387593265298,0.8422336207426879,66,49,17,25,10,10,31,24,5,7
"wisconsin_exoplanets-anthropic3710,wisconsin_exoplanets-llama,wisconsin_exoplanets-phi","5,2,1",0.7619047619047619,0.6378836219672017,0.8601883518609403,63,48,0.7121212121212122,0.5874932401392494,0.816959774581892,66,47,16,26,9,13,32,21,6,6
"wisconsin_exoplanets-geminipro,wisconsin_exoplanets-gemma,wisconsin_exoplanets-openaio1","2,1,2",0.7619047619047619,0.6378836219672017,0.8601883518609403,63,48,0.5454545454545454,0.4181368331466126,0.6685606183790747,66,36,12,6,5,4,36,30,10,26
"wisconsin_exoplanets-gemini,wisconsin_exoplanets-geminipro10,wisconsin_exoplanets-llamaphi","7,3,1",0.7619047619047619,0.6378836219672017,0.8601883518609403,63,48,0.6666666666666666,0.5398613431497497,0.7779692372780057,66,44,14,18,7,8,34,26,8,14
"wisconsin_exoplanets-anthropic,wisconsin_exoplanets-openai45,wisconsin_exoplanets-openaio1","2,4,2",0.7619047619047619,0.6378836219672017,0.8601883518609403,63,48,0.8181818181818182,0.7039345441700697,0.9023647979841516,66,54,20,28,13,8,28,26,2,4
"wisconsin_exoplanets-geminipro10,wisconsin_exoplanets-gemma,wisconsin_exoplanets-openaio1","3,1,2",0.7619047619047619,0.6378836219672017,0.8601883518609403,63,48,0.5909090909090909,0.46293656355858825,0.7104508976039902,66,39,12,9,5,4,36,30,10,23
"wisconsin_exoplanets-anthropic,wisconsin_exoplanets-geminipro10,wisconsin_exoplanets-llamaphi","2,3,1",0.7619047619047619,0.6378836219672017,0.8601883518609403,63,48,0.7878787878787878,0.6697885403521799,0.8788980677448571,66,52,17,24,10,6,31,28,5,8
"wisconsin_exoplanets-anthropic3710,wisconsin_exoplanets-gemini10,wisconsin_exoplanets-geminipro","5,2,2",0.7619047619047619,0.6378836219672017,0.8601883518609403,63,48,0.6666666666666666,0.5398613431497497,0.7779692372780057,66,44,7,10,0,0,41,34,15,22
"wisconsin_exoplanets-anthropic,wisconsin_exoplanets-geminipro10,wisconsin_exoplanets-gemma","2,3,1",0.7619047619047619,0.6378836219672017,0.8601883518609403,63,48,0.6818181818181818,0.5556078292305275,0.7911016327585585,66,45,12,13,5,2,36,32,10,19
"wisconsin_exoplanets-anthropic,wisconsin_exoplanets-openailong,wisconsin_exoplanets-openaio1","2,4,2",0.7619047619047619,0.6378836219672017,0.8601883518609403,63,48,0.803030303030303,0.6867611541519056,0.8907397343822825,66,53,20,28,13,9,28,25,2,4
"wisconsin_exoplanets-gemini10,wisconsin_exoplanets-openaio1,wisconsin_exoplanets-qwq","2,2,1",0.7619047619047619,0.6378836219672017,0.8601883518609403,63,48,0.6818181818181818,0.5556078292305275,0.7911016327585585,66,45,10,14,3,3,38,31,12,18
"wisconsin_exoplanets-gemini,wisconsin_exoplanets-geminipro10,wisconsin_exoplanets-openai10o1","7,3,5",0.7619047619047619,0.6378836219672017,0.8601883518609403,63,48,0.6818181818181818,0.5556078292305275,0.7911016327585585,66,45,14,18,7,7,34,27,8,14
"wisconsin_exoplanets-gemini,wisconsin_exoplanets-geminipro10,wisconsin_exoplanets-openai45","7,3,4",0.7619047619047619,0.6378836219672017,0.8601883518609403,63,48,0.6666666666666666,0.5398613431497497,0.7779692372780057,66,44,15,18,8,8,33,26,7,14
"wisconsin_exoplanets-gemini,wisconsin_exoplanets-gemini10,wisconsin_exoplanets-openai10o1","7,2,5",0.7619047619047619,0.6378836219672017,0.8601883518609403,63,48,0.7121212121212122,0.5874932401392494,0.816959774581892,66,47,14,20,7,7,34,27,8,12
"wisconsin_exoplanets-gemini,wisconsin_exoplanets-gemini10,wisconsin_exoplanets-openai4510","7,2,2",0.7619047619047619,0.6378836219672017,0.8601883518609403,63,48,0.6666666666666666,0.5398613431497497,0.7779692372780057,66,44,7,10,0,0,41,34,15,22
"wisconsin_exoplanets-falcon10,wisconsin_exoplanets-gemini10,wisconsin_exoplanets-openai4510","1,2,2",0.7619047619047619,0.6378836219672017,0.8601883518609403,63,48,0.7272727272727273,0.6036427957562946,0.8296733838204806,66,48,7,14,0,0,41,34,15,18
"wisconsin_exoplanets-geminipro10,wisconsin_exoplanets-openai,wisconsin_exoplanets-openai45","3,6,4",0.7619047619047619,0.6378836219672017,0.8601883518609403,63,48,0.6515151515151515,0.5242397683271001,0.7647080305896783,66,43,10,10,3,1,38,33,12,22
"wisconsin_exoplanets-falcon10,wisconsin_exoplanets-gemini,wisconsin_exoplanets-geminipro","1,7,2",0.7619047619047619,0.6378836219672017,0.8601883518609403,63,48,0.6212121212121212,0.4933571772023376,0.7378154230046878,66,41,10,13,3,6,38,28,12,19
"wisconsin_exoplanets-anthropic,wisconsin_exoplanets-falcon,wisconsin_exoplanets-gemini","2,1,7",0.7619047619047619,0.6378836219672017,0.8601883518609403,63,48,0.7424242424242424,0.6199387593265298,0.8422336207426879,66,49,17,21,10,6,31,28,5,11
"wisconsin_exoplanets-gemini,wisconsin_exoplanets-gemini10,wisconsin_exoplanets-gemma","7,2,1",0.7619047619047619,0.6378836219672017,0.8601883518609403,63,48,0.5757575757575758,0.4478940377087594,0.6965980669616616,66,38,10,9,3,5,38,29,12,23
"wisconsin_exoplanets-gemini,wisconsin_exoplanets-gemini10,wisconsin_exoplanets-geminipro10","7,2,3",0.7619047619047619,0.6378836219672017,0.8601883518609403,63,48,0.6515151515151515,0.5242397683271001,0.7647080305896783,66,43,9,10,2,1,39,33,13,22
"wisconsin_exoplanets-falcon,wisconsin_exoplanets-geminipro10,wisconsin_exoplanets-openaio1","1,3,2",0.7619047619047619,0.6378836219672017,0.8601883518609403,63,48,0.5909090909090909,0.46293656355858825,0.7104508976039902,66,39,13,11,6,6,35,28,9,21
"wisconsin_exoplanets-gemini,wisconsin_exoplanets-openai,wisconsin_exoplanets-openai10","7,6,5",0.7619047619047619,0.6378836219672017,0.8601883518609403,63,48,0.6818181818181818,0.5556078292305275,0.7911016327585585,66,45,16,21,9,10,32,24,6,11
"wisconsin_exoplanets-gemini,wisconsin_exoplanets-llamaphi,wisconsin_exoplanets-openailong","7,1,4",0.7619047619047619,0.6378836219672017,0.8601883518609403,63,48,0.6212121212121212,0.4933571772023376,0.7378154230046878,66,41,16,19,9,12,32,22,6,13
"wisconsin_exoplanets-geminipro10,wisconsin_exoplanets-openai,wisconsin_exoplanets-openailong","3,6,4",0.7619047619047619,0.6378836219672017,0.8601883518609403,63,48,0.6363636363636364,0.5087394315103153,0.7513222169426668,66,42,9,10,2,2,39,32,13,22
"wisconsin_exoplanets-falcon10,wisconsin_exoplanets-gemini10,wisconsin_exoplanets-geminipro10","1,2,3",0.7619047619047619,0.6378836219672017,0.8601883518609403,63,48,0.6515151515151515,0.5242397683271001,0.7647080305896783,66,43,7,9,0,0,41,34,15,23
"wisconsin_exoplanets-gemini,wisconsin_exoplanets-llamaphi,wisconsin_exoplanets-openai10o1","7,1,5",0.7619047619047619,0.6378836219672017,0.8601883518609403,63,48,0.6060606060606061,0.47809031269657515,0.7241907640463761,66,40,16,18,9,12,32,22,6,14
"wisconsin_exoplanets-anthropic,wisconsin_exoplanets-deepseek,wisconsin_exoplanets-geminipro","2,1,2",0.7619047619047619,0.6378836219672017,0.8601883518609403,63,48,0.803030303030303,0.6867611541519056,0.8907397343822825,66,53,11,20,4,1,37,33,11,12
"wisconsin_exoplanets-gemini10,wisconsin_exoplanets-gemma,wisconsin_exoplanets-openai4510","2,1,2",0.7619047619047619,0.6378836219672017,0.8601883518609403,63,48,0.6363636363636364,0.5087394315103153,0.7513222169426668,66,42,7,9,0,1,41,33,15,23
"wisconsin_exoplanets-gemini10,wisconsin_exoplanets-geminipro10,wisconsin_exoplanets-openai45","2,3,4",0.7619047619047619,0.6378836219672017,0.8601883518609403,63,48,0.6818181818181818,0.5556078292305275,0.7911016327585585,66,45,9,12,2,1,39,33,13,20
"wisconsin_exoplanets-gemini10,wisconsin_exoplanets-geminipro10,wisconsin_exoplanets-openai10o1","2,3,5",0.7619047619047619,0.6378836219672017,0.8601883518609403,63,48,0.6818181818181818,0.5556078292305275,0.7911016327585585,66,45,9,12,2,1,39,33,13,20
"wisconsin_exoplanets-deepseek,wisconsin_exoplanets-llama,wisconsin_exoplanets-openaio1","1,2,2",0.7619047619047619,0.6378836219672017,0.8601883518609403,63,48,0.696969696969697,0.5714834854226349,0.8041003533935258,66,46,17,22,10,10,31,24,5,10
"wisconsin_exoplanets-gemini10,wisconsin_exoplanets-geminipro10,wisconsin_exoplanets-openai10","2,3,5",0.7619047619047619,0.6378836219672017,0.8601883518609403,63,48,0.6818181818181818,0.5556078292305275,0.7911016327585585,66,45,9,12,2,1,39,33,13,20
"wisconsin_exoplanets-anthropic37,wisconsin_exoplanets-gemini10,wisconsin_exoplanets-qwq","2,2,1",0.7619047619047619,0.6378836219672017,0.8601883518609403,63,48,0.696969696969697,0.5714834854226349,0.8041003533935258,66,46,10,17,3,5,38,29,12,15
"wisconsin_exoplanets-gemini10,wisconsin_exoplanets-llama,wisconsin_exoplanets-openai4510","2,2,2",0.7619047619047619,0.6378836219672017,0.8601883518609403,63,48,0.696969696969697,0.5714834854226349,0.8041003533935258,66,46,8,13,1,1,40,33,14,19
"wisconsin_exoplanets-gemini10,wisconsin_exoplanets-geminipro10,wisconsin_exoplanets-openai","2,3,6",0.7619047619047619,0.6378836219672017,0.8601883518609403,63,48,0.6818181818181818,0.5556078292305275,0.7911016327585585,66,45,9,12,2,1,39,33,13,20
"wisconsin_exoplanets-falcon10,wisconsin_exoplanets-geminipro,wisconsin_exoplanets-openaio1","1,2,2",0.7619047619047619,0.6378836219672017,0.8601883518609403,63,48,0.6666666666666666,0.5398613431497497,0.7779692372780057,66,44,12,14,5,4,36,30,10,18
"wisconsin_exoplanets-anthropic,wisconsin_exoplanets-falcon10,wisconsin_exoplanets-gemini10","2,1,2",0.7619047619047619,0.6378836219672017,0.8601883518609403,63,48,0.7424242424242424,0.6199387593265298,0.8422336207426879,66,49,12,18,5,3,36,31,10,14
"wisconsin_exoplanets-falcon10,wisconsin_exoplanets-geminipro,wisconsin_exoplanets-openai4510","1,2,2",0.7619047619047619,0.6378836219672017,0.8601883518609403,63,48,0.6515151515151515,0.5242397683271001,0.7647080305896783,66,43,8,9,1,0,40,34,14,23
"wisconsin_exoplanets-geminipro10,wisconsin_exoplanets-llama,wisconsin_exoplanets-openai4510","3,2,2",0.7619047619047619,0.6378836219672017,0.8601883518609403,63,48,0.6818181818181818,0.5556078292305275,0.7911016327585585,66,45,8,12,1,1,40,33,14,20
"wisconsin_exoplanets-gemini10,wisconsin_exoplanets-geminipro10,wisconsin_exoplanets-openailong","2,3,4",0.7619047619047619,0.6378836219672017,0.8601883518609403,63,48,0.6818181818181818,0.5556078292305275,0.7911016327585585,66,45,9,12,2,1,39,33,13,20
"wisconsin_exoplanets-openai45,wisconsin_exoplanets-openai4510,wisconsin_exoplanets-openaio1","4,2,2",0.7547169811320755,0.6171753417731265,0.8624488244476837,53,40,0.7,0.5786660719574953,0.8037730367005361,70,49,17,13,8,10,23,36,5,11
"wisconsin_exoplanets-openai45,wisconsin_exoplanets-openai4510,wisconsin_exoplanets-qwq","4,2,1",0.7547169811320755,0.6171753417731265,0.8624488244476837,53,40,0.7,0.5786660719574953,0.8037730367005361,70,49,17,13,8,10,23,36,5,11
"wisconsin_exoplanets-openai10o1,wisconsin_exoplanets-openai4510,wisconsin_exoplanets-phi","5,2,1",0.7547169811320755,0.6171753417731265,0.8624488244476837,53,40,0.7090909090909091,0.5710174174438851,0.8237003426417631,55,39,12,6,1,1,28,33,12,15
"wisconsin_exoplanets-openai10o1,wisconsin_exoplanets-openai4510,wisconsin_exoplanets-openaio1","5,2,2",0.7547169811320755,0.6171753417731265,0.8624488244476837,53,40,0.6909090909090909,0.5518702546562255,0.8085535885663784,55,38,12,6,1,2,28,32,12,15
"wisconsin_exoplanets-openai10,wisconsin_exoplanets-openai10o1,wisconsin_exoplanets-openai45","5,5,4",0.7547169811320755,0.6171753417731265,0.8624488244476837,53,40,0.7571428571428571,0.639884758007587,0.8517109722037491,70,53,19,21,10,14,21,32,3,3
"wisconsin_exoplanets-openai45,wisconsin_exoplanets-openaio1,wisconsin_exoplanets-qwq","4,2,1",0.7547169811320755,0.6171753417731265,0.8624488244476837,53,40,0.6714285714285714,0.5487808972951265,0.7790506436403595,70,47,17,12,8,11,23,35,5,12
"wisconsin_exoplanets-openai10o1,wisconsin_exoplanets-openai4510,wisconsin_exoplanets-qwq","5,2,1",0.7547169811320755,0.6171753417731265,0.8624488244476837,53,40,0.7090909090909091,0.5710174174438851,0.8237003426417631,55,39,12,6,1,1,28,33,12,15
"wisconsin_exoplanets-geminipro,wisconsin_exoplanets-geminipro10,wisconsin_exoplanets-phi","2,3,1",0.746031746031746,0.6205970714475044,0.8473301812029235,63,47,0.5606060606060606,0.43296119670295957,0.6826341362307495,66,37,6,4,0,1,41,33,16,28
"wisconsin_exoplanets-anthropic37,wisconsin_exoplanets-deepseek,wisconsin_exoplanets-llama","2,1,2",0.746031746031746,0.6205970714475044,0.8473301812029235,63,47,0.6818181818181818,0.5556078292305275,0.7911016327585585,66,45,17,27,11,16,30,18,5,5
"wisconsin_exoplanets-gemini10,wisconsin_exoplanets-openai,wisconsin_exoplanets-openailong","2,6,4",0.746031746031746,0.6205970714475044,0.8473301812029235,63,47,0.6818181818181818,0.5556078292305275,0.7911016327585585,66,45,6,12,0,1,41,33,16,20
"wisconsin_exoplanets-gemini,wisconsin_exoplanets-geminipro,wisconsin_exoplanets-openai10o1","7,2,5",0.746031746031746,0.6205970714475044,0.8473301812029235,63,47,0.6666666666666666,0.5398613431497497,0.7779692372780057,66,44,13,17,7,7,34,27,9,15
"wisconsin_exoplanets-gemini10,wisconsin_exoplanets-openai,wisconsin_exoplanets-openai45","2,6,4",0.746031746031746,0.6205970714475044,0.8473301812029235,63,47,0.696969696969697,0.5714834854226349,0.8041003533935258,66,46,7,12,1,0,40,34,15,20
"wisconsin_exoplanets-geminipro,wisconsin_exoplanets-geminipro10,wisconsin_exoplanets-openaio1","2,3,2",0.746031746031746,0.6205970714475044,0.8473301812029235,63,47,0.5909090909090909,0.46293656355858825,0.7104508976039902,66,39,6,6,0,1,41,33,16,26
"wisconsin_exoplanets-anthropic10,wisconsin_exoplanets-gemini10,wisconsin_exoplanets-openai4510","1,2,2",0.746031746031746,0.6205970714475044,0.8473301812029235,63,47,0.6666666666666666,0.5398613431497497,0.7779692372780057,66,44,6,11,0,1,41,33,16,21
"wisconsin_exoplanets-falcon10,wisconsin_exoplanets-gemini,wisconsin_exoplanets-geminipro10","1,7,3",0.746031746031746,0.6205970714475044,0.8473301812029235,63,47,0.6515151515151515,0.5242397683271001,0.7647080305896783,66,43,11,15,5,6,36,28,11,17
"wisconsin_exoplanets-deepseek,wisconsin_exoplanets-gemini,wisconsin_exoplanets-phi","1,7,1",0.746031746031746,0.6205970714475044,0.8473301812029235,63,47,0.6818181818181818,0.5556078292305275,0.7911016327585585,66,45,15,21,9,10,32,24,7,11
"wisconsin_exoplanets-geminipro,wisconsin_exoplanets-gemma,wisconsin_exoplanets-openai4510","2,1,2",0.746031746031746,0.6205970714475044,0.8473301812029235,63,47,0.5757575757575758,0.4478940377087594,0.6965980669616616,66,38,6,6,0,2,41,32,16,26
"wisconsin_exoplanets-falcon,wisconsin_exoplanets-gemini,wisconsin_exoplanets-geminipro10","1,7,3",0.746031746031746,0.6205970714475044,0.8473301812029235,63,47,0.5606060606060606,0.43296119670295957,0.6826341362307495,66,37,10,8,4,5,37,29,12,24
"wisconsin_exoplanets-anthropic3710,wisconsin_exoplanets-falcon10,wisconsin_exoplanets-gemma","5,1,1",0.746031746031746,0.6205970714475044,0.8473301812029235,63,47,0.696969696969697,0.5714834854226349,0.8041003533935258,66,46,17,24,11,12,30,22,5,8
"wisconsin_exoplanets-falcon,wisconsin_exoplanets-gemini10,wisconsin_exoplanets-openaio1","1,2,2",0.746031746031746,0.6205970714475044,0.8473301812029235,63,47,0.6212121212121212,0.4933571772023376,0.7378154230046878,66,41,10,13,4,6,37,28,12,19
"wisconsin_exoplanets-falcon,wisconsin_exoplanets-geminipro,wisconsin_exoplanets-openaio1","1,2,2",0.746031746031746,0.6205970714475044,0.8473301812029235,63,47,0.5757575757575758,0.4478940377087594,0.6965980669616616,66,38,10,10,4,6,37,28,12,22
"wisconsin_exoplanets-falcon,wisconsin_exoplanets-gemma,wisconsin_exoplanets-openaio1","1,1,2",0.746031746031746,0.6205970714475044,0.8473301812029235,63,47,0.5303030303030303,0.403420053441725,0.654378697236779,66,35,16,12,10,11,31,23,6,20
"wisconsin_exoplanets-anthropic,wisconsin_exoplanets-falcon10,wisconsin_exoplanets-geminipro10","2,1,3",0.746031746031746,0.6205970714475044,0.8473301812029235,63,47,0.7575757575757576,0.6363888076622838,0.8546316735018541,66,50,12,19,6,3,35,31,10,13
"wisconsin_exoplanets-anthropic10,wisconsin_exoplanets-geminipro10,wisconsin_exoplanets-openai4510","1,3,2",0.746031746031746,0.6205970714475044,0.8473301812029235,63,47,0.5909090909090909,0.46293656355858825,0.7104508976039902,66,39,7,7,1,2,40,32,15,25
"wisconsin_exoplanets-geminipro,wisconsin_exoplanets-geminipro10,wisconsin_exoplanets-gemma","2,3,1",0.746031746031746,0.6205970714475044,0.8473301812029235,63,47,0.5454545454545454,0.4181368331466126,0.6685606183790747,66,36,6,3,0,1,41,33,16,29
"wisconsin_exoplanets-anthropic,wisconsin_exoplanets-gemini,wisconsin_exoplanets-openailong","2,7,4",0.746031746031746,0.6205970714475044,0.8473301812029235,63,47,0.7727272727272727,0.6530018980228203,0.8668572164845951,66,51,19,29,13,12,28,22,3,3
"wisconsin_exoplanets-anthropic3710,wisconsin_exoplanets-llama,wisconsin_exoplanets-openai","5,2,6",0.746031746031746,0.6205970714475044,0.8473301812029235,63,47,0.696969696969697,0.5714834854226349,0.8041003533935258,66,46,21,30,15,18,26,16,1,2
"wisconsin_exoplanets-anthropic,wisconsin_exoplanets-falcon10,wisconsin_exoplanets-geminipro","2,1,2",0.746031746031746,0.6205970714475044,0.8473301812029235,63,47,0.7424242424242424,0.6199387593265298,0.8422336207426879,66,49,11,18,5,3,36,31,11,14
"wisconsin_exoplanets-gemini10,wisconsin_exoplanets-geminipro10,wisconsin_exoplanets-llamaphi","2,3,1",0.746031746031746,0.6205970714475044,0.8473301812029235,63,47,0.6666666666666666,0.5398613431497497,0.7779692372780057,66,44,8,11,2,1,39,33,14,21
"wisconsin_exoplanets-gemini10,wisconsin_exoplanets-geminipro,wisconsin_exoplanets-openailong","2,2,4",0.746031746031746,0.6205970714475044,0.8473301812029235,63,47,0.6515151515151515,0.5242397683271001,0.7647080305896783,66,43,7,10,1,1,40,33,15,22
"wisconsin_exoplanets-gemini,wisconsin_exoplanets-geminipro,wisconsin_exoplanets-openailong","7,2,4",0.746031746031746,0.6205970714475044,0.8473301812029235,63,47,0.6515151515151515,0.5242397683271001,0.7647080305896783,66,43,14,17,8,8,33,26,8,15
"wisconsin_exoplanets-gemini,wisconsin_exoplanets-gemini10,wisconsin_exoplanets-openailong","7,2,4",0.746031746031746,0.6205970714475044,0.8473301812029235,63,47,0.696969696969697,0.5714834854226349,0.8041003533935258,66,46,14,20,8,8,33,26,8,12
"wisconsin_exoplanets-gemini10,wisconsin_exoplanets-geminipro,wisconsin_exoplanets-openai45","2,2,4",0.746031746031746,0.6205970714475044,0.8473301812029235,63,47,0.6515151515151515,0.5242397683271001,0.7647080305896783,66,43,7,10,1,1,40,33,15,22
"wisconsin_exoplanets-anthropic,wisconsin_exoplanets-gemini,wisconsin_exoplanets-gemma","2,7,1",0.746031746031746,0.6205970714475044,0.8473301812029235,63,47,0.6818181818181818,0.5556078292305275,0.7911016327585585,66,45,15,18,9,7,32,27,7,14
"wisconsin_exoplanets-anthropic,wisconsin_exoplanets-falcon,wisconsin_exoplanets-geminipro10","2,1,3",0.746031746031746,0.6205970714475044,0.8473301812029235,63,47,0.7121212121212122,0.5874932401392494,0.816959774581892,66,47,13,14,7,1,34,33,9,18
"wisconsin_exoplanets-anthropic,wisconsin_exoplanets-gemini,wisconsin_exoplanets-openai45","2,7,4",0.746031746031746,0.6205970714475044,0.8473301812029235,63,47,0.7878787878787878,0.6697885403521799,0.8788980677448571,66,52,19,29,13,11,28,23,3,3
"wisconsin_exoplanets-gemini10,wisconsin_exoplanets-geminipro,wisconsin_exoplanets-openai10","2,2,5",0.746031746031746,0.6205970714475044,0.8473301812029235,63,47,0.6515151515151515,0.5242397683271001,0.7647080305896783,66,43,7,10,1,1,40,33,15,22
"wisconsin_exoplanets-gemini10,wisconsin_exoplanets-gemma,wisconsin_exoplanets-openaio1","2,1,2",0.746031746031746,0.6205970714475044,0.8473301812029235,63,47,0.6212121212121212,0.4933571772023376,0.7378154230046878,66,41,11,10,5,3,36,31,11,22
"wisconsin_exoplanets-gemini10,wisconsin_exoplanets-geminipro,wisconsin_exoplanets-openai","2,2,6",0.746031746031746,0.6205970714475044,0.8473301812029235,63,47,0.6515151515151515,0.5242397683271001,0.7647080305896783,66,43,7,10,1,1,40,33,15,22
"wisconsin_exoplanets-anthropic,wisconsin_exoplanets-gemini10,wisconsin_exoplanets-geminipro","2,2,2",0.746031746031746,0.6205970714475044,0.8473301812029235,63,47,0.6666666666666666,0.5398613431497497,0.7779692372780057,66,44,7,10,1,0,40,34,15,22
"wisconsin_exoplanets-anthropic3710,wisconsin_exoplanets-geminipro,wisconsin_exoplanets-qwq","5,2,1",0.746031746031746,0.6205970714475044,0.8473301812029235,63,47,0.6818181818181818,0.5556078292305275,0.7911016327585585,66,45,9,13,3,2,38,32,13,19
"wisconsin_exoplanets-gemini,wisconsin_exoplanets-openai4510,wisconsin_exoplanets-qwq","7,2,1",0.746031746031746,0.6205970714475044,0.8473301812029235,63,47,0.6212121212121212,0.4933571772023376,0.7378154230046878,66,41,9,11,3,4,38,30,13,21
"wisconsin_exoplanets-anthropic3710,wisconsin_exoplanets-geminipro,wisconsin_exoplanets-geminipro10","5,2,3",0.746031746031746,0.6205970714475044,0.8473301812029235,63,47,0.5909090909090909,0.46293656355858825,0.7104508976039902,66,39,6,6,0,1,41,33,16,26
"wisconsin_exoplanets-anthropic3710,wisconsin_exoplanets-gemini10,wisconsin_exoplanets-qwq","5,2,1",0.746031746031746,0.6205970714475044,0.8473301812029235,63,47,0.7272727272727273,0.6036427957562946,0.8296733838204806,66,48,8,16,2,2,39,32,14,16
"wisconsin_exoplanets-gemini,wisconsin_exoplanets-gemini10,wisconsin_exoplanets-geminipro","7,2,2",0.746031746031746,0.6205970714475044,0.8473301812029235,63,47,0.6060606060606061,0.47809031269657515,0.7241907640463761,66,40,7,7,1,1,40,33,15,25
"wisconsin_exoplanets-gemini10,wisconsin_exoplanets-geminipro10,wisconsin_exoplanets-gemma","2,3,1",0.746031746031746,0.6205970714475044,0.8473301812029235,63,47,0.5757575757575758,0.4478940377087594,0.6965980669616616,66,38,6,5,0,1,41,33,16,27
"wisconsin_exoplanets-gemini10,wisconsin_exoplanets-geminipro10,wisconsin_exoplanets-phi","2,3,1",0.746031746031746,0.6205970714475044,0.8473301812029235,63,47,0.6060606060606061,0.47809031269657515,0.7241907640463761,66,40,6,6,0,0,41,34,16,26
"wisconsin_exoplanets-falcon10,wisconsin_exoplanets-llama,wisconsin_exoplanets-openaio1","1,2,2",0.746031746031746,0.6205970714475044,0.8473301812029235,63,47,0.6060606060606061,0.47809031269657515,0.7241907640463761,66,40,18,20,12,14,29,20,4,12
"wisconsin_exoplanets-gemini,wisconsin_exoplanets-geminipro,wisconsin_exoplanets-openai4510","7,2,2",0.746031746031746,0.6205970714475044,0.8473301812029235,63,47,0.5909090909090909,0.46293656355858825,0.7104508976039902,66,39,7,6,1,1,40,33,15,26
"wisconsin_exoplanets-anthropic10,wisconsin_exoplanets-geminipro,wisconsin_exoplanets-openaio1","1,2,2",0.746031746031746,0.6205970714475044,0.8473301812029235,63,47,0.6515151515151515,0.5242397683271001,0.7647080305896783,66,43,10,15,4,6,37,28,12,17
"wisconsin_exoplanets-anthropic37,wisconsin_exoplanets-geminipro,wisconsin_exoplanets-geminipro10","2,2,3",0.746031746031746,0.6205970714475044,0.8473301812029235,63,47,0.5909090909090909,0.46293656355858825,0.7104508976039902,66,39,6,6,0,1,41,33,16,26
"wisconsin_exoplanets-anthropic37,wisconsin_exoplanets-falcon,wisconsin_exoplanets-gemma","2,1,1",0.746031746031746,0.6205970714475044,0.8473301812029235,63,47,0.6060606060606061,0.47809031269657515,0.7241907640463761,66,40,18,21,12,15,29,19,4,11
"wisconsin_exoplanets-gemini,wisconsin_exoplanets-llamaphi,wisconsin_exoplanets-openai10","7,1,5",0.746031746031746,0.6205970714475044,0.8473301812029235,63,47,0.6363636363636364,0.5087394315103153,0.7513222169426668,66,42,16,20,10,12,31,22,6,12
"wisconsin_exoplanets-gemma,wisconsin_exoplanets-openai,wisconsin_exoplanets-openaio1","1,6,2",0.746031746031746,0.6205970714475044,0.8473301812029235,63,47,0.5606060606060606,0.43296119670295957,0.6826341362307495,66,37,22,22,16,19,25,15,0,10
"wisconsin_exoplanets-gemini,wisconsin_exoplanets-openai10,wisconsin_exoplanets-openailong","7,5,4",0.746031746031746,0.6205970714475044,0.8473301812029235,63,47,0.6515151515151515,0.5242397683271001,0.7647080305896783,66,43,14,18,8,9,33,25,8,14
"wisconsin_exoplanets-anthropic3710,wisconsin_exoplanets-deepseek,wisconsin_exoplanets-falcon10","5,1,1",0.746031746031746,0.6205970714475044,0.8473301812029235,63,47,0.7727272727272727,0.6530018980228203,0.8668572164845951,66,51,16,26,10,9,31,25,6,6
"wisconsin_exoplanets-gemma,wisconsin_exoplanets-llamaphi,wisconsin_exoplanets-openaio1","1,1,2",0.746031746031746,0.6205970714475044,0.8473301812029235,63,47,0.5606060606060606,0.43296119670295957,0.6826341362307495,66,37,22,22,16,19,25,15,0,10
"wisconsin_exoplanets-geminipro10,wisconsin_exoplanets-openai,wisconsin_exoplanets-openai10o1","3,6,5",0.746031746031746,0.6205970714475044,0.8473301812029235,63,47,0.6212121212121212,0.4933571772023376,0.7378154230046878,66,41,8,9,2,2,39,32,14,23
"wisconsin_exoplanets-anthropic,wisconsin_exoplanets-openai10o1,wisconsin_exoplanets-openaio1","2,5,2",0.746031746031746,0.6205970714475044,0.8473301812029235,63,47,0.803030303030303,0.6867611541519056,0.8907397343822825,66,53,19,28,13,9,28,25,3,4
"wisconsin_exoplanets-gemini,wisconsin_exoplanets-openai10o1,wisconsin_exoplanets-openai45","7,5,4",0.746031746031746,0.6205970714475044,0.8473301812029235,63,47,0.6363636363636364,0.5087394315103153,0.7513222169426668,66,42,15,18,9,10,32,24,7,14
"wisconsin_exoplanets-anthropic37,wisconsin_exoplanets-falcon,wisconsin_exoplanets-geminipro10","2,1,3",0.746031746031746,0.6205970714475044,0.8473301812029235,63,47,0.6818181818181818,0.5556078292305275,0.7911016327585585,66,45,13,16,7,5,34,29,9,16
"wisconsin_exoplanets-gemini,wisconsin_exoplanets-geminipro10,wisconsin_exoplanets-openailong","7,3,4",0.746031746031746,0.6205970714475044,0.8473301812029235,63,47,0.6666666666666666,0.5398613431497497,0.7779692372780057,66,44,14,18,8,8,33,26,8,14
"wisconsin_exoplanets-anthropic10,wisconsin_exoplanets-anthropic37,wisconsin_exoplanets-deepseek","1,2,1",0.746031746031746,0.6205970714475044,0.8473301812029235,63,47,0.6515151515151515,0.5242397683271001,0.7647080305896783,66,43,17,25,11,16,30,18,5,7
"wisconsin_exoplanets-geminipro,wisconsin_exoplanets-openai4510,wisconsin_exoplanets-phi","2,2,1",0.746031746031746,0.6205970714475044,0.8473301812029235,63,47,0.6515151515151515,0.5242397683271001,0.7647080305896783,66,43,7,10,1,1,40,33,15,22
"wisconsin_exoplanets-anthropic37,wisconsin_exoplanets-falcon,wisconsin_exoplanets-gemini10","2,1,2",0.746031746031746,0.6205970714475044,0.8473301812029235,63,47,0.7121212121212122,0.5874932401392494,0.816959774581892,66,47,11,18,5,5,36,29,11,14
"wisconsin_exoplanets-gemini,wisconsin_exoplanets-llamaphi,wisconsin_exoplanets-openai45","7,1,4",0.746031746031746,0.6205970714475044,0.8473301812029235,63,47,0.6363636363636364,0.5087394315103153,0.7513222169426668,66,42,16,19,10,11,31,23,6,13
"wisconsin_exoplanets-anthropic37,wisconsin_exoplanets-falcon10,wisconsin_exoplanets-gemma","2,1,1",0.746031746031746,0.6205970714475044,0.8473301812029235,63,47,0.6515151515151515,0.5242397683271001,0.7647080305896783,66,43,17,23,11,14,30,20,5,9
"wisconsin_exoplanets-anthropic10,wisconsin_exoplanets-gemini,wisconsin_exoplanets-openai4510","1,7,2",0.746031746031746,0.6205970714475044,0.8473301812029235,63,47,0.6363636363636364,0.5087394315103153,0.7513222169426668,66,42,10,14,4,6,37,28,12,18
"wisconsin_exoplanets-anthropic37,wisconsin_exoplanets-geminipro,wisconsin_exoplanets-qwq","2,2,1",0.746031746031746,0.6205970714475044,0.8473301812029235,63,47,0.6515151515151515,0.5242397683271001,0.7647080305896783,66,43,10,14,4,5,37,29,12,18
"wisconsin_exoplanets-gemini,wisconsin_exoplanets-geminipro10,wisconsin_exoplanets-qwq","7,3,1",0.746031746031746,0.6205970714475044,0.8473301812029235,63,47,0.5757575757575758,0.4478940377087594,0.6965980669616616,66,38,10,9,4,5,37,29,12,23
"wisconsin_exoplanets-anthropic3710,wisconsin_exoplanets-deepseek,wisconsin_exoplanets-openai10","5,1,5",0.746031746031746,0.6205970714475044,0.8473301812029235,63,47,0.7121212121212122,0.5874932401392494,0.816959774581892,66,47,21,30,15,17,26,17,1,2
"wisconsin_exoplanets-anthropic3710,wisconsin_exoplanets-deepseek,wisconsin_exoplanets-openailong","5,1,4",0.746031746031746,0.6205970714475044,0.8473301812029235,63,47,0.696969696969697,0.5714834854226349,0.8041003533935258,66,46,21,29,15,17,26,17,1,3
"wisconsin_exoplanets-anthropic37,wisconsin_exoplanets-llama,wisconsin_exoplanets-phi","2,2,1",0.746031746031746,0.6205970714475044,0.8473301812029235,63,47,0.7121212121212122,0.5874932401392494,0.816959774581892,66,47,17,26,11,13,30,21,5,6
"wisconsin_exoplanets-llama,wisconsin_exoplanets-openai,wisconsin_exoplanets-openaio1","2,6,2",0.746031746031746,0.6205970714475044,0.8473301812029235,63,47,0.6212121212121212,0.4933571772023376,0.7378154230046878,66,41,21,28,15,21,26,13,1,4
"wisconsin_exoplanets-anthropic37,wisconsin_exoplanets-gemini10,wisconsin_exoplanets-geminipro","2,2,2",0.746031746031746,0.6205970714475044,0.8473301812029235,63,47,0.6666666666666666,0.5398613431497497,0.7779692372780057,66,44,6,10,0,0,41,34,16,22
"wisconsin_exoplanets-gemini,wisconsin_exoplanets-geminipro10,wisconsin_exoplanets-gemma","7,3,1",0.746031746031746,0.6205970714475044,0.8473301812029235,63,47,0.5606060606060606,0.43296119670295957,0.6826341362307495,66,37,11,8,5,5,36,29,11,24
"wisconsin_exoplanets-anthropic3710,wisconsin_exoplanets-falcon,wisconsin_exoplanets-gemma","5,1,1",0.746031746031746,0.6205970714475044,0.8473301812029235,63,47,0.6212121212121212,0.4933571772023376,0.7378154230046878,66,41,17,18,11,11,30,23,5,14
"wisconsin_exoplanets-anthropic3710,wisconsin_exoplanets-falcon,wisconsin_exoplanets-geminipro","5,1,2",0.746031746031746,0.6205970714475044,0.8473301812029235,63,47,0.7121212121212122,0.5874932401392494,0.816959774581892,66,47,8,15,2,2,39,32,14,17
"wisconsin_exoplanets-anthropic3710,wisconsin_exoplanets-falcon,wisconsin_exoplanets-gemini10","5,1,2",0.746031746031746,0.6205970714475044,0.8473301812029235,63,47,0.7575757575757576,0.6363888076622838,0.8546316735018541,66,50,8,18,2,2,39,32,14,14
"wisconsin_exoplanets-openai45,wisconsin_exoplanets-openaio1,wisconsin_exoplanets-phi","4,2,1",0.7358490566037735,0.5967207691499998,0.8474316399025805,53,39,0.6714285714285714,0.5487808972951265,0.7790506436403595,70,47,17,12,9,11,22,35,5,12
"wisconsin_exoplanets-openai45,wisconsin_exoplanets-openai4510,wisconsin_exoplanets-phi","4,2,1",0.7358490566037735,0.5967207691499998,0.8474316399025805,53,39,0.7,0.5786660719574953,0.8037730367005361,70,49,17,13,9,10,22,36,5,11
"wisconsin_exoplanets-openai45,wisconsin_exoplanets-phi,wisconsin_exoplanets-qwq","4,1,1",0.7358490566037735,0.5967207691499998,0.8474316399025805,53,39,0.6571428571428571,0.5340040349627563,0.7665184652917468,70,46,17,12,9,12,22,34,5,12
"wisconsin_exoplanets-geminipro10,wisconsin_exoplanets-openai4510,wisconsin_exoplanets-qwq","3,2,1",0.7301587301587301,0.6034852807065079,0.8342874215660394,63,46,0.6363636363636364,0.5087394315103153,0.7513222169426668,66,42,6,8,1,0,40,34,16,24
"wisconsin_exoplanets-anthropic,wisconsin_exoplanets-deepseek,wisconsin_exoplanets-llama","2,1,2",0.7301587301587301,0.6034852807065079,0.8342874215660394,63,46,0.7575757575757576,0.6363888076622838,0.8546316735018541,66,50,17,25,12,9,29,25,5,7
"wisconsin_exoplanets-anthropic37,wisconsin_exoplanets-deepseek,wisconsin_exoplanets-openai","2,1,6",0.7301587301587301,0.6034852807065079,0.8342874215660394,63,46,0.6666666666666666,0.5398613431497497,0.7779692372780057,66,44,21,30,16,20,25,14,1,2
"wisconsin_exoplanets-gemma,wisconsin_exoplanets-llama,wisconsin_exoplanets-openaio1","1,2,2",0.7301587301587301,0.6034852807065079,0.8342874215660394,63,46,0.5909090909090909,0.46293656355858825,0.7104508976039902,66,39,17,15,12,10,29,24,5,17
"wisconsin_exoplanets-anthropic,wisconsin_exoplanets-gemini,wisconsin_exoplanets-openai","2,7,6",0.7301587301587301,0.6034852807065079,0.8342874215660394,63,46,0.7424242424242424,0.6199387593265298,0.8422336207426879,66,49,19,27,14,12,27,22,3,5
"wisconsin_exoplanets-anthropic,wisconsin_exoplanets-gemini,wisconsin_exoplanets-llamaphi","2,7,1",0.7301587301587301,0.6034852807065079,0.8342874215660394,63,46,0.7424242424242424,0.6199387593265298,0.8422336207426879,66,49,19,27,14,12,27,22,3,5
"wisconsin_exoplanets-anthropic37,wisconsin_exoplanets-gemma,wisconsin_exoplanets-phi","2,1,1",0.7301587301587301,0.6034852807065079,0.8342874215660394,63,46,0.5606060606060606,0.43296119670295957,0.6826341362307495,66,37,16,19,11,16,30,18,6,13
"wisconsin_exoplanets-anthropic37,wisconsin_exoplanets-gemma,wisconsin_exoplanets-openai","2,1,6",0.7301587301587301,0.6034852807065079,0.8342874215660394,63,46,0.6212121212121212,0.4933571772023376,0.7378154230046878,66,41,21,29,16,22,25,12,1,3
"wisconsin_exoplanets-gemini,wisconsin_exoplanets-gemini10,wisconsin_exoplanets-openai10","7,2,5",0.7301587301587301,0.6034852807065079,0.8342874215660394,63,46,0.696969696969697,0.5714834854226349,0.8041003533935258,66,46,13,20,8,8,33,26,9,12
"wisconsin_exoplanets-anthropic,wisconsin_exoplanets-falcon10,wisconsin_exoplanets-llama","2,1,2",0.7301587301587301,0.6034852807065079,0.8342874215660394,63,46,0.696969696969697,0.5714834854226349,0.8041003533935258,66,46,18,23,13,11,28,23,4,9
"wisconsin_exoplanets-gemini10,wisconsin_exoplanets-geminipro,wisconsin_exoplanets-openai10o1","2,2,5",0.7301587301587301,0.6034852807065079,0.8342874215660394,63,46,0.6515151515151515,0.5242397683271001,0.7647080305896783,66,43,6,10,1,1,40,33,16,22
"wisconsin_exoplanets-gemini,wisconsin_exoplanets-geminipro,wisconsin_exoplanets-qwq","7,2,1",0.7301587301587301,0.6034852807065079,0.8342874215660394,63,46,0.5606060606060606,0.43296119670295957,0.6826341362307495,66,37,8,8,3,5,38,29,14,24
"wisconsin_exoplanets-anthropic37,wisconsin_exoplanets-falcon10,wisconsin_exoplanets-phi","2,1,1",0.7301587301587301,0.6034852807065079,0.8342874215660394,63,46,0.6515151515151515,0.5242397683271001,0.7647080305896783,66,43,16,25,11,16,30,18,6,7
"wisconsin_exoplanets-deepseek,wisconsin_exoplanets-falcon10,wisconsin_exoplanets-openaio1","1,1,2",0.7301587301587301,0.6034852807065079,0.8342874215660394,63,46,0.6666666666666666,0.5398613431497497,0.7779692372780057,66,44,17,19,12,9,29,25,5,13
"wisconsin_exoplanets-anthropic10,wisconsin_exoplanets-gemma,wisconsin_exoplanets-openaio1","1,1,2",0.7301587301587301,0.6034852807065079,0.8342874215660394,63,46,0.5909090909090909,0.46293656355858825,0.7104508976039902,66,39,15,17,10,12,31,22,7,15
"wisconsin_exoplanets-gemini10,wisconsin_exoplanets-openai,wisconsin_exoplanets-openai10o1","2,6,5",0.7301587301587301,0.6034852807065079,0.8342874215660394,63,46,0.6666666666666666,0.5398613431497497,0.7779692372780057,66,44,5,11,0,1,41,33,17,21
"wisconsin_exoplanets-deepseek,wisconsin_exoplanets-gemma,wisconsin_exoplanets-openai4510","1,1,2",0.7301587301587301,0.6034852807065079,0.8342874215660394,63,46,0.5909090909090909,0.46293656355858825,0.7104508976039902,66,39,13,13,8,8,33,26,9,19
"wisconsin_exoplanets-deepseek,wisconsin_exoplanets-gemma,wisconsin_exoplanets-openaio1","1,1,2",0.7301587301587301,0.6034852807065079,0.8342874215660394,63,46,0.6515151515151515,0.5242397683271001,0.7647080305896783,66,43,17,18,12,9,29,25,5,14
"wisconsin_exoplanets-anthropic10,wisconsin_exoplanets-gemini,wisconsin_exoplanets-gemini10","1,7,2",0.7301587301587301,0.6034852807065079,0.8342874215660394,63,46,0.6666666666666666,0.5398613431497497,0.7779692372780057,66,44,9,15,4,5,37,29,13,17
"wisconsin_exoplanets-anthropic,wisconsin_exoplanets-anthropic10,wisconsin_exoplanets-geminipro10","2,1,3",0.7301587301587301,0.6034852807065079,0.8342874215660394,63,46,0.7121212121212122,0.5874932401392494,0.816959774581892,66,47,10,16,5,3,36,31,12,16
"wisconsin_exoplanets-deepseek,wisconsin_exoplanets-openaio1,wisconsin_exoplanets-phi","1,2,1",0.7301587301587301,0.6034852807065079,0.8342874215660394,63,46,0.7272727272727273,0.6036427957562946,0.8296733838204806,66,48,17,21,12,7,29,27,5,11
"wisconsin_exoplanets-geminipro10,wisconsin_exoplanets-llamaphi,wisconsin_exoplanets-openai","3,1,6",0.7301587301587301,0.6034852807065079,0.8342874215660394,63,46,0.6212121212121212,0.4933571772023376,0.7378154230046878,66,41,7,8,2,1,39,33,15,24
"wisconsin_exoplanets-falcon,wisconsin_exoplanets-gemini,wisconsin_exoplanets-openai4510","1,7,2",0.7301587301587301,0.6034852807065079,0.8342874215660394,63,46,0.6212121212121212,0.4933571772023376,0.7378154230046878,66,41,10,12,5,5,36,29,12,20
"wisconsin_exoplanets-anthropic10,wisconsin_exoplanets-llama,wisconsin_exoplanets-openaio1","1,2,2",0.7301587301587301,0.6034852807065079,0.8342874215660394,63,46,0.5757575757575758,0.4478940377087594,0.6965980669616616,66,38,15,19,10,15,31,19,7,13
"wisconsin_exoplanets-falcon,wisconsin_exoplanets-gemini10,wisconsin_exoplanets-openai4510","1,2,2",0.7301587301587301,0.6034852807065079,0.8342874215660394,63,46,0.6515151515151515,0.5242397683271001,0.7647080305896783,66,43,6,10,1,1,40,33,16,22
"wisconsin_exoplanets-geminipro10,wisconsin_exoplanets-llamaphi,wisconsin_exoplanets-openai45","3,1,4",0.7301587301587301,0.6034852807065079,0.8342874215660394,63,46,0.6212121212121212,0.4933571772023376,0.7378154230046878,66,41,9,10,4,3,37,31,13,22
"wisconsin_exoplanets-geminipro10,wisconsin_exoplanets-openai45,wisconsin_exoplanets-openailong","3,4,4",0.7301587301587301,0.6034852807065079,0.8342874215660394,63,46,0.6060606060606061,0.47809031269657515,0.7241907640463761,66,40,7,7,2,1,39,33,15,25
"wisconsin_exoplanets-geminipro10,wisconsin_exoplanets-llamaphi,wisconsin_exoplanets-openailong","3,1,4",0.7301587301587301,0.6034852807065079,0.8342874215660394,63,46,0.6060606060606061,0.47809031269657515,0.7241907640463761,66,40,8,10,3,4,38,30,14,22
"wisconsin_exoplanets-falcon,wisconsin_exoplanets-llama,wisconsin_exoplanets-openaio1","1,2,2",0.7301587301587301,0.6034852807065079,0.8342874215660394,63,46,0.6060606060606061,0.47809031269657515,0.7241907640463761,66,40,16,18,11,12,30,22,6,14
"wisconsin_exoplanets-falcon,wisconsin_exoplanets-openai4510,wisconsin_exoplanets-openaio1","1,2,2",0.7301587301587301,0.6034852807065079,0.8342874215660394,63,46,0.6060606060606061,0.47809031269657515,0.7241907640463761,66,40,10,13,5,7,36,27,12,19
"wisconsin_exoplanets-geminipro10,wisconsin_exoplanets-openai,wisconsin_exoplanets-openai10","3,6,5",0.7301587301587301,0.6034852807065079,0.8342874215660394,63,46,0.6515151515151515,0.5242397683271001,0.7647080305896783,66,43,8,11,3,2,38,32,14,21
"wisconsin_exoplanets-falcon10,wisconsin_exoplanets-gemini,wisconsin_exoplanets-llama","1,7,2",0.7301587301587301,0.6034852807065079,0.8342874215660394,63,46,0.5909090909090909,0.46293656355858825,0.7104508976039902,66,39,16,20,11,15,30,19,6,12
"wisconsin_exoplanets-gemini10,wisconsin_exoplanets-llamaphi,wisconsin_exoplanets-openailong","2,1,4",0.7301587301587301,0.6034852807065079,0.8342874215660394,63,46,0.6666666666666666,0.5398613431497497,0.7779692372780057,66,44,6,13,1,3,40,31,16,19
"wisconsin_exoplanets-gemini10,wisconsin_exoplanets-llamaphi,wisconsin_exoplanets-openai45","2,1,4",0.7301587301587301,0.6034852807065079,0.8342874215660394,63,46,0.6818181818181818,0.5556078292305275,0.7911016327585585,66,45,7,13,2,2,39,32,15,19
"wisconsin_exoplanets-anthropic10,wisconsin_exoplanets-gemini,wisconsin_exoplanets-geminipro10","1,7,3",0.7301587301587301,0.6034852807065079,0.8342874215660394,63,46,0.6666666666666666,0.5398613431497497,0.7779692372780057,66,44,10,15,5,5,36,29,12,17
"wisconsin_exoplanets-gemini,wisconsin_exoplanets-openai10,wisconsin_exoplanets-openai10o1","7,5,5",0.7301587301587301,0.6034852807065079,0.8342874215660394,63,46,0.6363636363636364,0.5087394315103153,0.7513222169426668,66,42,14,19,9,11,32,23,8,13
"wisconsin_exoplanets-gemini10,wisconsin_exoplanets-llamaphi,wisconsin_exoplanets-openai","2,1,6",0.7301587301587301,0.6034852807065079,0.8342874215660394,63,46,0.6818181818181818,0.5556078292305275,0.7911016327585585,66,45,5,11,0,0,41,34,17,21
"wisconsin_exoplanets-falcon10,wisconsin_exoplanets-gemma,wisconsin_exoplanets-openaio1","1,1,2",0.7301587301587301,0.6034852807065079,0.8342874215660394,63,46,0.5909090909090909,0.46293656355858825,0.7104508976039902,66,39,16,17,11,12,30,22,6,15
"wisconsin_exoplanets-anthropic,wisconsin_exoplanets-gemini,wisconsin_exoplanets-openai10o1","2,7,5",0.7301587301587301,0.6034852807065079,0.8342874215660394,63,46,0.7727272727272727,0.6530018980228203,0.8668572164845951,66,51,18,28,13,11,28,23,4,4
"wisconsin_exoplanets-gemini10,wisconsin_exoplanets-geminipro10,wisconsin_exoplanets-llama","2,3,2",0.7301587301587301,0.6034852807065079,0.8342874215660394,63,46,0.6212121212121212,0.4933571772023376,0.7378154230046878,66,41,5,7,0,0,41,34,17,25
"wisconsin_exoplanets-anthropic37,wisconsin_exoplanets-falcon,wisconsin_exoplanets-geminipro","2,1,2",0.7301587301587301,0.6034852807065079,0.8342874215660394,63,46,0.6666666666666666,0.5398613431497497,0.7779692372780057,66,44,10,15,5,5,36,29,12,17
"wisconsin_exoplanets-anthropic,wisconsin_exoplanets-geminipro10,wisconsin_exoplanets-phi","2,3,1",0.7301587301587301,0.6034852807065079,0.8342874215660394,63,46,0.7121212121212122,0.5874932401392494,0.816959774581892,66,47,10,15,5,2,36,32,12,17
"wisconsin_exoplanets-anthropic,wisconsin_exoplanets-geminipro,wisconsin_exoplanets-phi","2,2,1",0.7301587301587301,0.6034852807065079,0.8342874215660394,63,46,0.6818181818181818,0.5556078292305275,0.7911016327585585,66,45,10,13,5,2,36,32,12,19
"wisconsin_exoplanets-anthropic,wisconsin_exoplanets-openai4510,wisconsin_exoplanets-qwq","2,2,1",0.7301587301587301,0.6034852807065079,0.8342874215660394,63,46,0.7575757575757576,0.6363888076622838,0.8546316735018541,66,50,11,18,6,2,35,32,11,14
"wisconsin_exoplanets-geminipro,wisconsin_exoplanets-openai,wisconsin_exoplanets-openailong","2,6,4",0.7301587301587301,0.6034852807065079,0.8342874215660394,63,46,0.5909090909090909,0.46293656355858825,0.7104508976039902,66,39,6,7,1,2,40,32,16,25
"wisconsin_exoplanets-gemini,wisconsin_exoplanets-geminipro10,wisconsin_exoplanets-openai10","7,3,5",0.7301587301587301,0.6034852807065079,0.8342874215660394,63,46,0.6666666666666666,0.5398613431497497,0.7779692372780057,66,44,13,18,8,8,33,26,9,14
"wisconsin_exoplanets-gemini,wisconsin_exoplanets-geminipro,wisconsin_exoplanets-openai10","7,2,5",0.7301587301587301,0.6034852807065079,0.8342874215660394,63,46,0.6515151515151515,0.5242397683271001,0.7647080305896783,66,43,13,17,8,8,33,26,9,15
"wisconsin_exoplanets-deepseek,wisconsin_exoplanets-geminipro,wisconsin_exoplanets-geminipro10","1,2,3",0.7301587301587301,0.6034852807065079,0.8342874215660394,63,46,0.5909090909090909,0.46293656355858825,0.7104508976039902,66,39,5,6,0,1,41,33,17,26
"wisconsin_exoplanets-gemini10,wisconsin_exoplanets-openai45,wisconsin_exoplanets-openailong","2,4,4",0.7301587301587301,0.6034852807065079,0.8342874215660394,63,46,0.6666666666666666,0.5398613431497497,0.7779692372780057,66,44,5,10,0,0,41,34,17,22
"wisconsin_exoplanets-anthropic37,wisconsin_exoplanets-deepseek,wisconsin_exoplanets-qwq","2,1,1",0.7301587301587301,0.6034852807065079,0.8342874215660394,63,46,0.6363636363636364,0.5087394315103153,0.7513222169426668,66,42,15,22,10,14,31,20,7,10
"wisconsin_exoplanets-anthropic37,wisconsin_exoplanets-deepseek,wisconsin_exoplanets-gemma","2,1,1",0.7301587301587301,0.6034852807065079,0.8342874215660394,63,46,0.6515151515151515,0.5242397683271001,0.7647080305896783,66,43,17,23,12,14,29,20,5,9
"wisconsin_exoplanets-anthropic3710,wisconsin_exoplanets-deepseek,wisconsin_exoplanets-gemma","5,1,1",0.7301587301587301,0.6034852807065079,0.8342874215660394,63,46,0.7121212121212122,0.5874932401392494,0.816959774581892,66,47,15,24,10,11,31,23,7,8
"wisconsin_exoplanets-gemini10,wisconsin_exoplanets-openai4510,wisconsin_exoplanets-qwq","2,2,1",0.7301587301587301,0.6034852807065079,0.8342874215660394,63,46,0.6212121212121212,0.4933571772023376,0.7378154230046878,66,41,5,7,0,0,41,34,17,25
"wisconsin_exoplanets-geminipro,wisconsin_exoplanets-openai,wisconsin_exoplanets-openai45","2,6,4",0.7301587301587301,0.6034852807065079,0.8342874215660394,63,46,0.6060606060606061,0.47809031269657515,0.7241907640463761,66,40,7,7,2,1,39,33,15,25
"wisconsin_exoplanets-anthropic,wisconsin_exoplanets-openai10,wisconsin_exoplanets-openaio1","2,5,2",0.7301587301587301,0.6034852807065079,0.8342874215660394,63,46,0.803030303030303,0.6867611541519056,0.8907397343822825,66,53,19,28,14,9,27,25,3,4
"wisconsin_exoplanets-anthropic3710,wisconsin_exoplanets-deepseek,wisconsin_exoplanets-falcon","5,1,1",0.7301587301587301,0.6034852807065079,0.8342874215660394,63,46,0.7575757575757576,0.6363888076622838,0.8546316735018541,66,50,15,24,10,8,31,26,7,8
"wisconsin_exoplanets-geminipro,wisconsin_exoplanets-llama,wisconsin_exoplanets-openai4510","2,2,2",0.7301587301587301,0.6034852807065079,0.8342874215660394,63,46,0.6515151515151515,0.5242397683271001,0.7647080305896783,66,43,7,10,2,1,39,33,15,22
"wisconsin_exoplanets-gemini10,wisconsin_exoplanets-geminipro,wisconsin_exoplanets-llamaphi","2,2,1",0.7301587301587301,0.6034852807065079,0.8342874215660394,63,46,0.6363636363636364,0.5087394315103153,0.7513222169426668,66,42,6,9,1,1,40,33,16,23
"wisconsin_exoplanets-anthropic37,wisconsin_exoplanets-deepseek,wisconsin_exoplanets-phi","2,1,1",0.7301587301587301,0.6034852807065079,0.8342874215660394,63,46,0.6666666666666666,0.5398613431497497,0.7779692372780057,66,44,17,24,12,14,29,20,5,8
"wisconsin_exoplanets-geminipro,wisconsin_exoplanets-geminipro10,wisconsin_exoplanets-openai4510","2,3,2",0.7142857142857143,0.5865389743313041,0.8210707933611636,63,45,0.5454545454545454,0.4181368331466126,0.6685606183790747,66,36,4,3,0,1,41,33,18,29
"wisconsin_exoplanets-anthropic37,wisconsin_exoplanets-deepseek,wisconsin_exoplanets-openailong","2,1,4",0.7142857142857143,0.5865389743313041,0.8210707933611636,63,45,0.6818181818181818,0.5556078292305275,0.7911016327585585,66,45,21,31,17,20,24,14,1,1
"wisconsin_exoplanets-anthropic10,wisconsin_exoplanets-gemini,wisconsin_exoplanets-llama","1,7,2",0.7142857142857143,0.5865389743313041,0.8210707933611636,63,45,0.5909090909090909,0.46293656355858825,0.7104508976039902,66,39,15,20,11,15,30,19,7,12
"wisconsin_exoplanets-geminipro10,wisconsin_exoplanets-openai10o1,wisconsin_exoplanets-openai45","3,5,4",0.7142857142857143,0.5865389743313041,0.8210707933611636,63,45,0.5909090909090909,0.46293656355858825,0.7104508976039902,66,39,7,7,3,2,38,32,15,25
"wisconsin_exoplanets-deepseek,wisconsin_exoplanets-openai45,wisconsin_exoplanets-openaio1","1,4,2",0.7142857142857143,0.5865389743313041,0.8210707933611636,63,45,0.5757575757575758,0.4478940377087594,0.6965980669616616,66,38,22,24,18,20,23,14,0,8
"wisconsin_exoplanets-anthropic,wisconsin_exoplanets-deepseek,wisconsin_exoplanets-falcon10","2,1,1",0.7142857142857143,0.5865389743313041,0.8210707933611636,63,45,0.7878787878787878,0.6697885403521799,0.8788980677448571,66,52,17,27,13,9,28,25,5,5
"wisconsin_exoplanets-anthropic37,wisconsin_exoplanets-deepseek,wisconsin_exoplanets-openai10o1","2,1,5",0.7142857142857143,0.5865389743313041,0.8210707933611636,63,45,0.6666666666666666,0.5398613431497497,0.7779692372780057,66,44,21,30,17,20,24,14,1,2
"wisconsin_exoplanets-geminipro10,wisconsin_exoplanets-openai10o1,wisconsin_exoplanets-openailong","3,5,4",0.7142857142857143,0.5865389743313041,0.8210707933611636,63,45,0.5757575757575758,0.4478940377087594,0.6965980669616616,66,38,6,7,2,3,39,31,16,25
"wisconsin_exoplanets-anthropic10,wisconsin_exoplanets-deepseek,wisconsin_exoplanets-openaio1","1,1,2",0.7142857142857143,0.5865389743313041,0.8210707933611636,63,45,0.5757575757575758,0.4478940377087594,0.6965980669616616,66,38,15,15,11,11,30,23,7,17
"wisconsin_exoplanets-geminipro,wisconsin_exoplanets-geminipro10,wisconsin_exoplanets-llama","2,3,2",0.7142857142857143,0.5865389743313041,0.8210707933611636,63,45,0.5757575757575758,0.4478940377087594,0.6965980669616616,66,38,5,5,1,1,40,33,17,27
"wisconsin_exoplanets-falcon10,wisconsin_exoplanets-openaio1,wisconsin_exoplanets-phi","1,2,1",0.7142857142857143,0.5865389743313041,0.8210707933611636,63,45,0.6212121212121212,0.4933571772023376,0.7378154230046878,66,41,17,19,13,12,28,22,5,13
"wisconsin_exoplanets-anthropic10,wisconsin_exoplanets-gemini,wisconsin_exoplanets-geminipro","1,7,2",0.7142857142857143,0.5865389743313041,0.8210707933611636,63,45,0.6363636363636364,0.5087394315103153,0.7513222169426668,66,42,8,13,4,5,37,29,14,19
"wisconsin_exoplanets-anthropic3710,wisconsin_exoplanets-deepseek,wisconsin_exoplanets-qwq","5,1,1",0.7142857142857143,0.5865389743313041,0.8210707933611636,63,45,0.696969696969697,0.5714834854226349,0.8041003533935258,66,46,13,23,9,11,32,23,9,9
"wisconsin_exoplanets-anthropic,wisconsin_exoplanets-anthropic10,wisconsin_exoplanets-llama","2,1,2",0.7142857142857143,0.5865389743313041,0.8210707933611636,63,45,0.6666666666666666,0.5398613431497497,0.7779692372780057,66,44,16,24,12,14,29,20,6,8
"wisconsin_exoplanets-falcon10,wisconsin_exoplanets-llama,wisconsin_exoplanets-openai4510","1,2,2",0.7142857142857143,0.5865389743313041,0.8210707933611636,63,45,0.6363636363636364,0.5087394315103153,0.7513222169426668,66,42,12,19,8,11,33,23,10,13
"wisconsin_exoplanets-gemini10,wisconsin_exoplanets-openai,wisconsin_exoplanets-openai10","2,6,5",0.7142857142857143,0.5865389743313041,0.8210707933611636,63,45,0.696969696969697,0.5714834854226349,0.8041003533935258,66,46,5,13,1,1,40,33,17,19
"wisconsin_exoplanets-falcon10,wisconsin_exoplanets-geminipro,wisconsin_exoplanets-geminipro10","1,2,3",0.7142857142857143,0.5865389743313041,0.8210707933611636,63,45,0.5757575757575758,0.4478940377087594,0.6965980669616616,66,38,5,5,1,1,40,33,17,27
"wisconsin_exoplanets-falcon10,wisconsin_exoplanets-gemini,wisconsin_exoplanets-phi","1,7,1",0.7142857142857143,0.5865389743313041,0.8210707933611636,63,45,0.5909090909090909,0.46293656355858825,0.7104508976039902,66,39,15,17,11,12,30,22,7,15
"wisconsin_exoplanets-anthropic,wisconsin_exoplanets-gemma,wisconsin_exoplanets-phi","2,1,1",0.7142857142857143,0.5865389743313041,0.8210707933611636,63,45,0.6363636363636364,0.5087394315103153,0.7513222169426668,66,42,15,18,11,10,30,24,7,14
"wisconsin_exoplanets-anthropic10,wisconsin_exoplanets-geminipro,wisconsin_exoplanets-openai4510","1,2,2",0.7142857142857143,0.5865389743313041,0.8210707933611636,63,45,0.5606060606060606,0.43296119670295957,0.6826341362307495,66,37,5,5,1,2,40,32,17,27
"wisconsin_exoplanets-falcon10,wisconsin_exoplanets-gemini10,wisconsin_exoplanets-gemma","1,2,1",0.7142857142857143,0.5865389743313041,0.8210707933611636,63,45,0.5757575757575758,0.4478940377087594,0.6965980669616616,66,38,12,13,8,9,33,25,10,19
"wisconsin_exoplanets-falcon10,wisconsin_exoplanets-gemini10,wisconsin_exoplanets-llama","1,2,2",0.7142857142857143,0.5865389743313041,0.8210707933611636,63,45,0.6060606060606061,0.47809031269657515,0.7241907640463761,66,40,11,16,7,10,34,24,11,16
"wisconsin_exoplanets-gemini10,wisconsin_exoplanets-llamaphi,wisconsin_exoplanets-openai10o1","2,1,5",0.7142857142857143,0.5865389743313041,0.8210707933611636,63,45,0.6515151515151515,0.5242397683271001,0.7647080305896783,66,43,5,12,1,3,40,31,17,20
"wisconsin_exoplanets-falcon10,wisconsin_exoplanets-gemini10,wisconsin_exoplanets-phi","1,2,1",0.7142857142857143,0.5865389743313041,0.8210707933611636,63,45,0.5909090909090909,0.46293656355858825,0.7104508976039902,66,39,12,13,8,8,33,26,10,19
"wisconsin_exoplanets-geminipro10,wisconsin_exoplanets-openai10,wisconsin_exoplanets-openai45","3,5,4",0.7142857142857143,0.5865389743313041,0.8210707933611636,63,45,0.6060606060606061,0.47809031269657515,0.7241907640463761,66,40,6,7,2,1,39,33,16,25
"wisconsin_exoplanets-anthropic37,wisconsin_exoplanets-deepseek,wisconsin_exoplanets-openai45","2,1,4",0.7142857142857143,0.5865389743313041,0.8210707933611636,63,45,0.696969696969697,0.5714834854226349,0.8041003533935258,66,46,21,31,17,19,24,15,1,1
"wisconsin_exoplanets-geminipro,wisconsin_exoplanets-openai,wisconsin_exoplanets-openai10o1","2,6,5",0.7142857142857143,0.5865389743313041,0.8210707933611636,63,45,0.5757575757575758,0.4478940377087594,0.6965980669616616,66,38,5,6,1,2,40,32,17,26
"wisconsin_exoplanets-anthropic37,wisconsin_exoplanets-falcon10,wisconsin_exoplanets-openai","2,1,6",0.7142857142857143,0.5865389743313041,0.8210707933611636,63,45,0.6212121212121212,0.4933571772023376,0.7378154230046878,66,41,21,29,17,22,24,12,1,3
"wisconsin_exoplanets-gemini10,wisconsin_exoplanets-openai10o1,wisconsin_exoplanets-openai45","2,5,4",0.7142857142857143,0.5865389743313041,0.8210707933611636,63,45,0.6515151515151515,0.5242397683271001,0.7647080305896783,66,43,5,10,1,1,40,33,17,22
"wisconsin_exoplanets-falcon10,wisconsin_exoplanets-gemma,wisconsin_exoplanets-openai4510","1,1,2",0.7142857142857143,0.5865389743313041,0.8210707933611636,63,45,0.5757575757575758,0.4478940377087594,0.6965980669616616,66,38,12,14,8,10,33,24,10,18
"wisconsin_exoplanets-anthropic3710,wisconsin_exoplanets-phi,wisconsin_exoplanets-qwq","5,1,1",0.7142857142857143,0.5865389743313041,0.8210707933611636,63,45,0.6666666666666666,0.5398613431497497,0.7779692372780057,66,44,14,19,10,9,31,25,8,13
"wisconsin_exoplanets-deepseek,wisconsin_exoplanets-openailong,wisconsin_exoplanets-openaio1","1,4,2",0.7142857142857143,0.5865389743313041,0.8210707933611636,63,45,0.5757575757575758,0.4478940377087594,0.6965980669616616,66,38,22,24,18,20,23,14,0,8
"wisconsin_exoplanets-geminipro10,wisconsin_exoplanets-openai10,wisconsin_exoplanets-openailong","3,5,4",0.7142857142857143,0.5865389743313041,0.8210707933611636,63,45,0.5909090909090909,0.46293656355858825,0.7104508976039902,66,39,6,7,2,2,39,32,16,25
"wisconsin_exoplanets-falcon10,wisconsin_exoplanets-geminipro10,wisconsin_exoplanets-llama","1,3,2",0.7142857142857143,0.5865389743313041,0.8210707933611636,63,45,0.5757575757575758,0.4478940377087594,0.6965980669616616,66,38,11,14,7,10,34,24,11,18
"wisconsin_exoplanets-gemini10,wisconsin_exoplanets-openai10,wisconsin_exoplanets-openai45","2,5,4",0.7142857142857143,0.5865389743313041,0.8210707933611636,63,45,0.6666666666666666,0.5398613431497497,0.7779692372780057,66,44,4,10,0,0,41,34,18,22
"wisconsin_exoplanets-geminipro10,wisconsin_exoplanets-llamaphi,wisconsin_exoplanets-openai10o1","3,1,5",0.7142857142857143,0.5865389743313041,0.8210707933611636,63,45,0.5909090909090909,0.46293656355858825,0.7104508976039902,66,39,7,9,3,4,38,30,15,23
"wisconsin_exoplanets-llama,wisconsin_exoplanets-openai,wisconsin_exoplanets-openai4510","2,6,2",0.7142857142857143,0.5865389743313041,0.8210707933611636,63,45,0.6060606060606061,0.47809031269657515,0.7241907640463761,66,40,18,21,14,15,27,19,4,11
"wisconsin_exoplanets-gemini10,wisconsin_exoplanets-geminipro,wisconsin_exoplanets-phi","2,2,1",0.7142857142857143,0.5865389743313041,0.8210707933611636,63,45,0.5757575757575758,0.4478940377087594,0.6965980669616616,66,38,4,4,0,0,41,34,18,28
"wisconsin_exoplanets-anthropic3710,wisconsin_exoplanets-llama,wisconsin_exoplanets-openai45","5,2,4",0.7142857142857143,0.5865389743313041,0.8210707933611636,63,45,0.6818181818181818,0.5556078292305275,0.7911016327585585,66,45,21,30,17,19,24,15,1,2
"wisconsin_exoplanets-anthropic3710,wisconsin_exoplanets-llama,wisconsin_exoplanets-openai10o1","5,2,5",0.7142857142857143,0.5865389743313041,0.8210707933611636,63,45,0.696969696969697,0.5714834854226349,0.8041003533935258,66,46,21,29,17,17,24,17,1,3
"wisconsin_exoplanets-gemini10,wisconsin_exoplanets-geminipro,wisconsin_exoplanets-gemma","2,2,1",0.7142857142857143,0.5865389743313041,0.8210707933611636,63,45,0.5606060606060606,0.43296119670295957,0.6826341362307495,66,37,4,4,0,1,41,33,18,28
"wisconsin_exoplanets-anthropic37,wisconsin_exoplanets-llama,wisconsin_exoplanets-openailong","2,2,4",0.7142857142857143,0.5865389743313041,0.8210707933611636,63,45,0.6515151515151515,0.5242397683271001,0.7647080305896783,66,43,22,30,18,21,23,13,0,2
"wisconsin_exoplanets-anthropic3710,wisconsin_exoplanets-llama,wisconsin_exoplanets-llamaphi","5,2,1",0.7142857142857143,0.5865389743313041,0.8210707933611636,63,45,0.6666666666666666,0.5398613431497497,0.7779692372780057,66,44,20,30,16,20,25,14,2,2
"wisconsin_exoplanets-anthropic,wisconsin_exoplanets-anthropic10,wisconsin_exoplanets-gemini10","2,1,2",0.7142857142857143,0.5865389743313041,0.8210707933611636,63,45,0.7272727272727273,0.6036427957562946,0.8296733838204806,66,48,9,16,5,2,36,32,13,16
"wisconsin_exoplanets-llama,wisconsin_exoplanets-llamaphi,wisconsin_exoplanets-openaio1","2,1,2",0.7142857142857143,0.5865389743313041,0.8210707933611636,63,45,0.6060606060606061,0.47809031269657515,0.7241907640463761,66,40,20,28,16,22,25,12,2,4
"wisconsin_exoplanets-geminipro10,wisconsin_exoplanets-llama,wisconsin_exoplanets-phi","3,2,1",0.7142857142857143,0.5865389743313041,0.8210707933611636,63,45,0.5909090909090909,0.46293656355858825,0.7104508976039902,66,39,12,13,8,8,33,26,10,19
"wisconsin_exoplanets-anthropic37,wisconsin_exoplanets-llama,wisconsin_exoplanets-openai45","2,2,4",0.7142857142857143,0.5865389743313041,0.8210707933611636,63,45,0.6515151515151515,0.5242397683271001,0.7647080305896783,66,43,22,30,18,21,23,13,0,2
"wisconsin_exoplanets-anthropic,wisconsin_exoplanets-falcon10,wisconsin_exoplanets-phi","2,1,1",0.7142857142857143,0.5865389743313041,0.8210707933611636,63,45,0.6818181818181818,0.5556078292305275,0.7911016327585585,66,45,17,22,13,11,28,23,5,10
"wisconsin_exoplanets-anthropic3710,wisconsin_exoplanets-gemma,wisconsin_exoplanets-openai","5,1,6",0.7142857142857143,0.5865389743313041,0.8210707933611636,63,45,0.6666666666666666,0.5398613431497497,0.7779692372780057,66,44,20,29,16,19,25,15,2,3
"wisconsin_exoplanets-anthropic3710,wisconsin_exoplanets-gemma,wisconsin_exoplanets-llamaphi","5,1,1",0.7142857142857143,0.5865389743313041,0.8210707933611636,63,45,0.6515151515151515,0.5242397683271001,0.7647080305896783,66,43,20,29,16,20,25,14,2,3
"wisconsin_exoplanets-gemini10,wisconsin_exoplanets-openai10,wisconsin_exoplanets-openailong","2,5,4",0.7142857142857143,0.5865389743313041,0.8210707933611636,63,45,0.6515151515151515,0.5242397683271001,0.7647080305896783,66,43,4,10,0,1,41,33,18,22
"wisconsin_exoplanets-gemini,wisconsin_exoplanets-gemma,wisconsin_exoplanets-llama","7,1,2",0.7142857142857143,0.5865389743313041,0.8210707933611636,63,45,0.5151515151515151,0.3888102652777774,0.6400892442500232,66,34,16,14,12,14,29,20,6,18
"wisconsin_exoplanets-anthropic10,wisconsin_exoplanets-anthropic3710,wisconsin_exoplanets-deepseek","1,5,1",0.7142857142857143,0.5865389743313041,0.8210707933611636,63,45,0.6515151515151515,0.5242397683271001,0.7647080305896783,66,43,14,22,10,13,31,21,8,10
"wisconsin_exoplanets-anthropic37,wisconsin_exoplanets-openai,wisconsin_exoplanets-qwq","2,6,1",0.7142857142857143,0.5865389743313041,0.8210707933611636,63,45,0.6212121212121212,0.4933571772023376,0.7378154230046878,66,41,21,29,17,22,24,12,1,3
"wisconsin_exoplanets-anthropic,wisconsin_exoplanets-gemini,wisconsin_exoplanets-openai10","2,7,5",0.7142857142857143,0.5865389743313041,0.8210707933611636,63,45,0.7727272727272727,0.6530018980228203,0.8668572164845951,66,51,18,29,14,12,27,22,4,3
"wisconsin_exoplanets-gemini10,wisconsin_exoplanets-geminipro,wisconsin_exoplanets-geminipro10","2,2,3",0.7142857142857143,0.5865389743313041,0.8210707933611636,63,45,0.5606060606060606,0.43296119670295957,0.6826341362307495,66,37,4,4,0,1,41,33,18,28
"wisconsin_exoplanets-gemma,wisconsin_exoplanets-openailong,wisconsin_exoplanets-openaio1","1,4,2",0.7142857142857143,0.5865389743313041,0.8210707933611636,63,45,0.5757575757575758,0.4478940377087594,0.6965980669616616,66,38,22,23,18,19,23,15,0,9
"wisconsin_exoplanets-gemma,wisconsin_exoplanets-openai10o1,wisconsin_exoplanets-openaio1","1,5,2",0.7142857142857143,0.5865389743313041,0.8210707933611636,63,45,0.5909090909090909,0.46293656355858825,0.7104508976039902,66,39,21,22,17,17,24,17,1,10
"wisconsin_exoplanets-gemma,wisconsin_exoplanets-openai45,wisconsin_exoplanets-openaio1","1,4,2",0.7142857142857143,0.5865389743313041,0.8210707933611636,63,45,0.5909090909090909,0.46293656355858825,0.7104508976039902,66,39,22,23,18,18,23,16,0,9
"wisconsin_exoplanets-deepseek,wisconsin_exoplanets-openai,wisconsin_exoplanets-openaio1","1,6,2",0.7142857142857143,0.5865389743313041,0.8210707933611636,63,45,0.6060606060606061,0.47809031269657515,0.7241907640463761,66,40,22,24,18,18,23,16,0,8
"wisconsin_exoplanets-anthropic,wisconsin_exoplanets-deepseek,wisconsin_exoplanets-phi","2,1,1",0.7142857142857143,0.5865389743313041,0.8210707933611636,63,45,0.7272727272727273,0.6036427957562946,0.8296733838204806,66,48,17,22,13,8,28,26,5,10
"wisconsin_exoplanets-anthropic37,wisconsin_exoplanets-gemma,wisconsin_exoplanets-llama","2,1,2",0.7142857142857143,0.5865389743313041,0.8210707933611636,63,45,0.6060606060606061,0.47809031269657515,0.7241907640463761,66,40,17,21,13,15,28,19,5,11
"wisconsin_exoplanets-anthropic3710,wisconsin_exoplanets-openai,wisconsin_exoplanets-qwq","5,6,1",0.7142857142857143,0.5865389743313041,0.8210707933611636,63,45,0.6666666666666666,0.5398613431497497,0.7779692372780057,66,44,20,27,16,17,25,17,2,5
"wisconsin_exoplanets-anthropic,wisconsin_exoplanets-falcon,wisconsin_exoplanets-gemini10","2,1,2",0.7142857142857143,0.5865389743313041,0.8210707933611636,63,45,0.7424242424242424,0.6199387593265298,0.8422336207426879,66,49,10,16,6,1,35,33,12,16
"wisconsin_exoplanets-anthropic37,wisconsin_exoplanets-gemma,wisconsin_exoplanets-llamaphi","2,1,1",0.7142857142857143,0.5865389743313041,0.8210707933611636,63,45,0.5909090909090909,0.46293656355858825,0.7104508976039902,66,39,21,28,17,23,24,11,1,4
"wisconsin_exoplanets-anthropic,wisconsin_exoplanets-geminipro,wisconsin_exoplanets-geminipro10","2,2,3",0.7142857142857143,0.5865389743313041,0.8210707933611636,63,45,0.5909090909090909,0.46293656355858825,0.7104508976039902,66,39,6,6,2,1,39,33,16,26
"wisconsin_exoplanets-deepseek,wisconsin_exoplanets-llama,wisconsin_exoplanets-openai4510","1,2,2",0.7142857142857143,0.5865389743313041,0.8210707933611636,63,45,0.6818181818181818,0.5556078292305275,0.7911016327585585,66,45,13,19,9,8,32,26,9,13
"wisconsin_exoplanets-anthropic3710,wisconsin_exoplanets-llamaphi,wisconsin_exoplanets-qwq","5,1,1",0.7142857142857143,0.5865389743313041,0.8210707933611636,63,45,0.6515151515151515,0.5242397683271001,0.7647080305896783,66,43,20,28,16,19,25,15,2,4
"wisconsin_exoplanets-gemini,wisconsin_exoplanets-gemini10,wisconsin_exoplanets-qwq","7,2,1",0.7142857142857143,0.5865389743313041,0.8210707933611636,63,45,0.6666666666666666,0.5398613431497497,0.7779692372780057,66,44,7,14,3,4,38,30,15,18
"wisconsin_exoplanets-anthropic37,wisconsin_exoplanets-deepseek,wisconsin_exoplanets-openai10","2,1,5",0.7142857142857143,0.5865389743313041,0.8210707933611636,63,45,0.6818181818181818,0.5556078292305275,0.7911016327585585,66,45,21,31,17,20,24,14,1,1
"wisconsin_exoplanets-anthropic3710,wisconsin_exoplanets-llama,wisconsin_exoplanets-qwq","5,2,1",0.7142857142857143,0.5865389743313041,0.8210707933611636,63,45,0.6363636363636364,0.5087394315103153,0.7513222169426668,66,42,15,21,11,13,30,21,7,11
"wisconsin_exoplanets-gemini10,wisconsin_exoplanets-openai10o1,wisconsin_exoplanets-openailong","2,5,4",0.7142857142857143,0.5865389743313041,0.8210707933611636,63,45,0.6363636363636364,0.5087394315103153,0.7513222169426668,66,42,4,10,0,2,41,32,18,22
"wisconsin_exoplanets-anthropic37,wisconsin_exoplanets-llama,wisconsin_exoplanets-openai10o1","2,2,5",0.7142857142857143,0.5865389743313041,0.8210707933611636,63,45,0.6666666666666666,0.5398613431497497,0.7779692372780057,66,44,22,30,18,20,23,14,0,2
"wisconsin_exoplanets-anthropic37,wisconsin_exoplanets-llama,wisconsin_exoplanets-openai","2,2,6",0.7142857142857143,0.5865389743313041,0.8210707933611636,63,45,0.6363636363636364,0.5087394315103153,0.7513222169426668,66,42,22,29,18,21,23,13,0,3
"wisconsin_exoplanets-anthropic37,wisconsin_exoplanets-gemma,wisconsin_exoplanets-qwq","2,1,1",0.7142857142857143,0.5865389743313041,0.8210707933611636,63,45,0.6363636363636364,0.5087394315103153,0.7513222169426668,66,42,17,20,13,12,28,22,5,12
"wisconsin_exoplanets-geminipro,wisconsin_exoplanets-openai4510,wisconsin_exoplanets-qwq","2,2,1",0.6984126984126984,0.5697502308863991,0.8076894190779017,63,44,0.5909090909090909,0.46293656355858825,0.7104508976039902,66,39,4,5,1,0,40,34,18,27
"wisconsin_exoplanets-deepseek,wisconsin_exoplanets-openai10,wisconsin_exoplanets-openaio1","1,5,2",0.6984126984126984,0.5697502308863991,0.8076894190779017,63,44,0.5909090909090909,0.46293656355858825,0.7104508976039902,66,39,22,25,19,20,22,14,0,7
"wisconsin_exoplanets-deepseek,wisconsin_exoplanets-llamaphi,wisconsin_exoplanets-openaio1","1,1,2",0.6984126984126984,0.5697502308863991,0.8076894190779017,63,44,0.5757575757575758,0.4478940377087594,0.6965980669616616,66,38,21,23,18,19,23,15,1,9
"wisconsin_exoplanets-geminipro,wisconsin_exoplanets-llamaphi,wisconsin_exoplanets-openai","2,1,6",0.6984126984126984,0.5697502308863991,0.8076894190779017,63,44,0.5757575757575758,0.4478940377087594,0.6965980669616616,66,38,4,5,1,1,40,33,18,27
"wisconsin_exoplanets-deepseek,wisconsin_exoplanets-geminipro10,wisconsin_exoplanets-phi","1,3,1",0.6984126984126984,0.5697502308863991,0.8076894190779017,63,44,0.6060606060606061,0.47809031269657515,0.7241907640463761,66,40,11,13,8,7,33,27,11,19
"wisconsin_exoplanets-geminipro,wisconsin_exoplanets-llamaphi,wisconsin_exoplanets-openailong","2,1,4",0.6984126984126984,0.5697502308863991,0.8076894190779017,63,44,0.5606060606060606,0.43296119670295957,0.6826341362307495,66,37,5,7,2,4,39,30,17,25
"wisconsin_exoplanets-gemini,wisconsin_exoplanets-geminipro,wisconsin_exoplanets-geminipro10","7,2,3",0.6984126984126984,0.5697502308863991,0.8076894190779017,63,44,0.5757575757575758,0.4478940377087594,0.6965980669616616,66,38,6,5,3,1,38,33,16,27
"wisconsin_exoplanets-geminipro,wisconsin_exoplanets-openai,wisconsin_exoplanets-openai10","2,6,5",0.6984126984126984,0.5697502308863991,0.8076894190779017,63,44,0.6060606060606061,0.47809031269657515,0.7241907640463761,66,40,5,8,2,2,39,32,17,24
"wisconsin_exoplanets-geminipro10,wisconsin_exoplanets-llamaphi,wisconsin_exoplanets-openai10","3,1,5",0.6984126984126984,0.5697502308863991,0.8076894190779017,63,44,0.6212121212121212,0.4933571772023376,0.7378154230046878,66,41,7,11,4,4,37,30,15,21
"wisconsin_exoplanets-falcon,wisconsin_exoplanets-gemini,wisconsin_exoplanets-gemini10","1,7,2",0.6984126984126984,0.5697502308863991,0.8076894190779017,63,44,0.6363636363636364,0.5087394315103153,0.7513222169426668,66,42,7,12,4,4,37,30,15,20
"wisconsin_exoplanets-geminipro,wisconsin_exoplanets-llamaphi,wisconsin_exoplanets-openai45","2,1,4",0.6984126984126984,0.5697502308863991,0.8076894190779017,63,44,0.5757575757575758,0.4478940377087594,0.6965980669616616,66,38,6,7,3,3,38,31,16,25
"wisconsin_exoplanets-llama,wisconsin_exoplanets-openai45,wisconsin_exoplanets-openai4510","2,4,2",0.6984126984126984,0.5697502308863991,0.8076894190779017,63,44,0.6363636363636364,0.5087394315103153,0.7513222169426668,66,42,18,23,15,15,26,19,4,9
"wisconsin_exoplanets-falcon,wisconsin_exoplanets-geminipro,wisconsin_exoplanets-openai4510","1,2,2",0.6984126984126984,0.5697502308863991,0.8076894190779017,63,44,0.6212121212121212,0.4933571772023376,0.7378154230046878,66,41,4,8,1,1,40,33,18,24
"wisconsin_exoplanets-falcon10,wisconsin_exoplanets-gemini,wisconsin_exoplanets-gemma","1,7,1",0.6984126984126984,0.5697502308863991,0.8076894190779017,63,44,0.5303030303030303,0.403420053441725,0.654378697236779,66,35,15,16,12,15,29,19,7,16
"wisconsin_exoplanets-llama,wisconsin_exoplanets-openai10o1,wisconsin_exoplanets-openaio1","2,5,2",0.6984126984126984,0.5697502308863991,0.8076894190779017,63,44,0.6515151515151515,0.5242397683271001,0.7647080305896783,66,43,21,27,18,18,23,16,1,5
"wisconsin_exoplanets-llama,wisconsin_exoplanets-openai10o1,wisconsin_exoplanets-openai4510","2,5,2",0.6984126984126984,0.5697502308863991,0.8076894190779017,63,44,0.6212121212121212,0.4933571772023376,0.7378154230046878,66,41,17,22,14,15,27,19,5,10
"wisconsin_exoplanets-llama,wisconsin_exoplanets-openai10,wisconsin_exoplanets-openaio1","2,5,2",0.6984126984126984,0.5697502308863991,0.8076894190779017,63,44,0.6212121212121212,0.4933571772023376,0.7378154230046878,66,41,21,28,18,21,23,13,1,4
"wisconsin_exoplanets-llama,wisconsin_exoplanets-openai4510,wisconsin_exoplanets-phi","2,2,1",0.6984126984126984,0.5697502308863991,0.8076894190779017,63,44,0.6060606060606061,0.47809031269657515,0.7241907640463761,66,40,11,14,8,8,33,26,11,18
"wisconsin_exoplanets-llama,wisconsin_exoplanets-llamaphi,wisconsin_exoplanets-openai4510","2,1,2",0.6984126984126984,0.5697502308863991,0.8076894190779017,63,44,0.5909090909090909,0.46293656355858825,0.7104508976039902,66,39,17,22,14,17,27,17,5,10
"wisconsin_exoplanets-gemini10,wisconsin_exoplanets-geminipro,wisconsin_exoplanets-llama","2,2,2",0.6984126984126984,0.5697502308863991,0.8076894190779017,63,44,0.6060606060606061,0.47809031269657515,0.7241907640463761,66,40,4,6,1,0,40,34,18,26
"wisconsin_exoplanets-gemma,wisconsin_exoplanets-openaio1,wisconsin_exoplanets-phi","1,2,1",0.6984126984126984,0.5697502308863991,0.8076894190779017,63,44,0.5303030303030303,0.403420053441725,0.654378697236779,66,35,16,13,13,12,28,22,6,19
"wisconsin_exoplanets-gemini,wisconsin_exoplanets-gemma,wisconsin_exoplanets-phi","7,1,1",0.6984126984126984,0.5697502308863991,0.8076894190779017,63,44,0.5303030303030303,0.403420053441725,0.654378697236779,66,35,15,14,12,13,29,21,7,18
"wisconsin_exoplanets-llama,wisconsin_exoplanets-openailong,wisconsin_exoplanets-openaio1","2,4,2",0.6984126984126984,0.5697502308863991,0.8076894190779017,63,44,0.6212121212121212,0.4933571772023376,0.7378154230046878,66,41,21,28,18,21,23,13,1,4
"wisconsin_exoplanets-llama,wisconsin_exoplanets-openaio1,wisconsin_exoplanets-phi","2,2,1",0.6984126984126984,0.5697502308863991,0.8076894190779017,63,44,0.6666666666666666,0.5398613431497497,0.7779692372780057,66,44,15,22,12,12,29,22,7,10
"wisconsin_exoplanets-gemini10,wisconsin_exoplanets-geminipro10,wisconsin_exoplanets-openai4510","2,3,2",0.6984126984126984,0.5697502308863991,0.8076894190779017,63,44,0.5757575757575758,0.4478940377087594,0.6965980669616616,66,38,3,4,0,0,41,34,19,28
"wisconsin_exoplanets-gemma,wisconsin_exoplanets-openai10,wisconsin_exoplanets-openaio1","1,5,2",0.6984126984126984,0.5697502308863991,0.8076894190779017,63,44,0.5909090909090909,0.46293656355858825,0.7104508976039902,66,39,21,24,18,19,23,15,1,8
"wisconsin_exoplanets-gemma,wisconsin_exoplanets-openai,wisconsin_exoplanets-openai4510","1,6,2",0.6984126984126984,0.5697502308863991,0.8076894190779017,63,44,0.5606060606060606,0.43296119670295957,0.6826341362307495,66,37,17,17,14,14,27,20,5,15
"wisconsin_exoplanets-llama,wisconsin_exoplanets-openaio1,wisconsin_exoplanets-qwq","2,2,1",0.6984126984126984,0.5697502308863991,0.8076894190779017,63,44,0.5454545454545454,0.4181368331466126,0.6685606183790747,66,36,14,15,11,13,30,21,8,17
"wisconsin_exoplanets-geminipro,wisconsin_exoplanets-openai45,wisconsin_exoplanets-openailong","2,4,4",0.6984126984126984,0.5697502308863991,0.8076894190779017,63,44,0.5606060606060606,0.43296119670295957,0.6826341362307495,66,37,4,4,1,1,40,33,18,28
"wisconsin_exoplanets-gemini10,wisconsin_exoplanets-openai10,wisconsin_exoplanets-openai10o1","2,5,5",0.6984126984126984,0.5697502308863991,0.8076894190779017,63,44,0.6515151515151515,0.5242397683271001,0.7647080305896783,66,43,4,11,1,2,40,32,18,21
"wisconsin_exoplanets-geminipro,wisconsin_exoplanets-geminipro10,wisconsin_exoplanets-llamaphi","2,3,1",0.6984126984126984,0.5697502308863991,0.8076894190779017,63,44,0.5909090909090909,0.46293656355858825,0.7104508976039902,66,39,6,6,3,1,38,33,16,26
"wisconsin_exoplanets-llama,wisconsin_exoplanets-openai45,wisconsin_exoplanets-openaio1","2,4,2",0.6984126984126984,0.5697502308863991,0.8076894190779017,63,44,0.6363636363636364,0.5087394315103153,0.7513222169426668,66,42,21,28,18,20,23,14,1,4
"wisconsin_exoplanets-geminipro,wisconsin_exoplanets-geminipro10,wisconsin_exoplanets-openai","2,3,6",0.6984126984126984,0.5697502308863991,0.8076894190779017,63,44,0.5909090909090909,0.46293656355858825,0.7104508976039902,66,39,6,6,3,1,38,33,16,26
"wisconsin_exoplanets-geminipro,wisconsin_exoplanets-geminipro10,wisconsin_exoplanets-openai10","2,3,5",0.6984126984126984,0.5697502308863991,0.8076894190779017,63,44,0.5909090909090909,0.46293656355858825,0.7104508976039902,66,39,6,6,3,1,38,33,16,26
"wisconsin_exoplanets-falcon10,wisconsin_exoplanets-geminipro10,wisconsin_exoplanets-phi","1,3,1",0.6984126984126984,0.5697502308863991,0.8076894190779017,63,44,0.5757575757575758,0.4478940377087594,0.6965980669616616,66,38,11,12,8,8,33,26,11,20
"wisconsin_exoplanets-gemini10,wisconsin_exoplanets-llamaphi,wisconsin_exoplanets-openai10","2,1,5",0.6984126984126984,0.5697502308863991,0.8076894190779017,63,44,0.6818181818181818,0.5556078292305275,0.7911016327585585,66,45,5,14,2,3,39,31,17,18
"wisconsin_exoplanets-falcon10,wisconsin_exoplanets-geminipro10,wisconsin_exoplanets-gemma","1,3,1",0.6984126984126984,0.5697502308863991,0.8076894190779017,63,44,0.5,0.37430716945155507,0.6256928305484449,66,33,11,9,8,10,33,24,11,23
"wisconsin_exoplanets-geminipro10,wisconsin_exoplanets-openai10,wisconsin_exoplanets-openai10o1","3,5,5",0.6984126984126984,0.5697502308863991,0.8076894190779017,63,44,0.5909090909090909,0.46293656355858825,0.7104508976039902,66,39,6,8,3,3,38,31,16,24
"wisconsin_exoplanets-geminipro,wisconsin_exoplanets-geminipro10,wisconsin_exoplanets-openai45","2,3,4",0.6984126984126984,0.5697502308863991,0.8076894190779017,63,44,0.5909090909090909,0.46293656355858825,0.7104508976039902,66,39,6,6,3,1,38,33,16,26
"wisconsin_exoplanets-falcon10,wisconsin_exoplanets-gemini10,wisconsin_exoplanets-geminipro","1,2,2",0.6984126984126984,0.5697502308863991,0.8076894190779017,63,44,0.6363636363636364,0.5087394315103153,0.7513222169426668,66,42,4,8,1,0,40,34,18,24
"wisconsin_exoplanets-geminipro,wisconsin_exoplanets-geminipro10,wisconsin_exoplanets-openailong","2,3,4",0.6984126984126984,0.5697502308863991,0.8076894190779017,63,44,0.5909090909090909,0.46293656355858825,0.7104508976039902,66,39,6,6,3,1,38,33,16,26
"wisconsin_exoplanets-gemini10,wisconsin_exoplanets-llama,wisconsin_exoplanets-openai","2,2,6",0.6984126984126984,0.5697502308863991,0.8076894190779017,63,44,0.6363636363636364,0.5087394315103153,0.7513222169426668,66,42,16,23,13,15,28,19,6,9
"wisconsin_exoplanets-openaio1,wisconsin_exoplanets-phi,wisconsin_exoplanets-qwq","2,1,1",0.6984126984126984,0.5697502308863991,0.8076894190779017,63,44,0.5909090909090909,0.46293656355858825,0.7104508976039902,66,39,14,15,11,10,30,24,8,17
"wisconsin_exoplanets-anthropic10,wisconsin_exoplanets-gemini10,wisconsin_exoplanets-geminipro","1,2,2",0.6984126984126984,0.5697502308863991,0.8076894190779017,63,44,0.6060606060606061,0.47809031269657515,0.7241907640463761,66,40,4,7,1,1,40,33,18,25
"wisconsin_exoplanets-anthropic10,wisconsin_exoplanets-gemini10,wisconsin_exoplanets-geminipro10","1,2,3",0.6984126984126984,0.5697502308863991,0.8076894190779017,63,44,0.6212121212121212,0.4933571772023376,0.7378154230046878,66,41,4,8,1,1,40,33,18,24
"wisconsin_exoplanets-anthropic,wisconsin_exoplanets-falcon,wisconsin_exoplanets-gemma","2,1,1",0.6984126984126984,0.5697502308863991,0.8076894190779017,63,44,0.6515151515151515,0.5242397683271001,0.7647080305896783,66,43,16,19,13,10,28,24,6,13
"wisconsin_exoplanets-anthropic,wisconsin_exoplanets-falcon,wisconsin_exoplanets-openai4510","2,1,2",0.6984126984126984,0.5697502308863991,0.8076894190779017,63,44,0.7575757575757576,0.6363888076622838,0.8546316735018541,66,50,10,18,7,2,34,32,12,14
"wisconsin_exoplanets-anthropic37,wisconsin_exoplanets-phi,wisconsin_exoplanets-qwq","2,1,1",0.6984126984126984,0.5697502308863991,0.8076894190779017,63,44,0.6212121212121212,0.4933571772023376,0.7378154230046878,66,41,15,20,12,13,29,21,7,12
"wisconsin_exoplanets-anthropic3710,wisconsin_exoplanets-llama,wisconsin_exoplanets-openailong","5,2,4",0.6984126984126984,0.5697502308863991,0.8076894190779017,63,44,0.6818181818181818,0.5556078292305275,0.7911016327585585,66,45,20,30,17,19,24,15,2,2
"wisconsin_exoplanets-anthropic3710,wisconsin_exoplanets-gemma,wisconsin_exoplanets-qwq","5,1,1",0.6984126984126984,0.5697502308863991,0.8076894190779017,63,44,0.6666666666666666,0.5398613431497497,0.7779692372780057,66,44,15,18,12,8,29,26,7,14
"wisconsin_exoplanets-anthropic3710,wisconsin_exoplanets-falcon,wisconsin_exoplanets-falcon10","5,1,1",0.6984126984126984,0.5697502308863991,0.8076894190779017,63,44,0.6666666666666666,0.5398613431497497,0.7779692372780057,66,44,15,24,12,14,29,20,7,8
"wisconsin_exoplanets-anthropic3710,wisconsin_exoplanets-falcon,wisconsin_exoplanets-llama","5,1,2",0.6984126984126984,0.5697502308863991,0.8076894190779017,63,44,0.6666666666666666,0.5398613431497497,0.7779692372780057,66,44,15,23,12,13,29,21,7,9
"wisconsin_exoplanets-anthropic,wisconsin_exoplanets-falcon,wisconsin_exoplanets-geminipro","2,1,2",0.6984126984126984,0.5697502308863991,0.8076894190779017,63,44,0.696969696969697,0.5714834854226349,0.8041003533935258,66,46,10,13,7,1,34,33,12,19
"wisconsin_exoplanets-anthropic3710,wisconsin_exoplanets-falcon10,wisconsin_exoplanets-llamaphi","5,1,1",0.6984126984126984,0.5697502308863991,0.8076894190779017,63,44,0.6666666666666666,0.5398613431497497,0.7779692372780057,66,44,20,30,17,20,24,14,2,2
"wisconsin_exoplanets-anthropic,wisconsin_exoplanets-geminipro,wisconsin_exoplanets-qwq","2,2,1",0.6984126984126984,0.5697502308863991,0.8076894190779017,63,44,0.696969696969697,0.5714834854226349,0.8041003533935258,66,46,9,14,6,2,35,32,13,18
"wisconsin_exoplanets-anthropic,wisconsin_exoplanets-geminipro10,wisconsin_exoplanets-qwq","2,3,1",0.6984126984126984,0.5697502308863991,0.8076894190779017,63,44,0.696969696969697,0.5714834854226349,0.8041003533935258,66,46,11,14,8,2,33,32,11,18
"wisconsin_exoplanets-anthropic3710,wisconsin_exoplanets-falcon10,wisconsin_exoplanets-openai","5,1,6",0.6984126984126984,0.5697502308863991,0.8076894190779017,63,44,0.6818181818181818,0.5556078292305275,0.7911016327585585,66,45,20,30,17,19,24,15,2,2
"wisconsin_exoplanets-deepseek,wisconsin_exoplanets-gemini10,wisconsin_exoplanets-gemma","1,2,1",0.6984126984126984,0.5697502308863991,0.8076894190779017,63,44,0.5909090909090909,0.46293656355858825,0.7104508976039902,66,39,11,12,8,7,33,27,11,20
"wisconsin_exoplanets-anthropic10,wisconsin_exoplanets-gemini,wisconsin_exoplanets-gemma","1,7,1",0.6984126984126984,0.5697502308863991,0.8076894190779017,63,44,0.5303030303030303,0.403420053441725,0.654378697236779,66,35,16,15,13,14,28,20,6,17
"wisconsin_exoplanets-deepseek,wisconsin_exoplanets-gemini10,wisconsin_exoplanets-geminipro10","1,2,3",0.6984126984126984,0.5697502308863991,0.8076894190779017,63,44,0.6515151515151515,0.5242397683271001,0.7647080305896783,66,43,3,10,0,1,41,33,19,22
"wisconsin_exoplanets-deepseek,wisconsin_exoplanets-gemini10,wisconsin_exoplanets-openai45","1,2,4",0.6984126984126984,0.5697502308863991,0.8076894190779017,63,44,0.6666666666666666,0.5398613431497497,0.7779692372780057,66,44,16,22,13,12,28,22,6,10
"wisconsin_exoplanets-anthropic37,wisconsin_exoplanets-falcon10,wisconsin_exoplanets-llamaphi","2,1,1",0.6984126984126984,0.5697502308863991,0.8076894190779017,63,44,0.6212121212121212,0.4933571772023376,0.7378154230046878,66,41,21,30,18,23,23,11,1,2
"wisconsin_exoplanets-anthropic37,wisconsin_exoplanets-deepseek,wisconsin_exoplanets-falcon","2,1,1",0.6984126984126984,0.5697502308863991,0.8076894190779017,63,44,0.7121212121212122,0.5874932401392494,0.816959774581892,66,47,16,24,13,11,28,23,6,8
"wisconsin_exoplanets-anthropic37,wisconsin_exoplanets-llama,wisconsin_exoplanets-llamaphi","2,2,1",0.6984126984126984,0.5697502308863991,0.8076894190779017,63,44,0.6515151515151515,0.5242397683271001,0.7647080305896783,66,43,21,30,18,21,23,13,1,2
"wisconsin_exoplanets-anthropic,wisconsin_exoplanets-anthropic10,wisconsin_exoplanets-geminipro","2,1,2",0.6984126984126984,0.5697502308863991,0.8076894190779017,63,44,0.696969696969697,0.5714834854226349,0.8041003533935258,66,46,8,15,5,3,36,31,14,17
"wisconsin_exoplanets-anthropic37,wisconsin_exoplanets-llama,wisconsin_exoplanets-openai10","2,2,5",0.6984126984126984,0.5697502308863991,0.8076894190779017,63,44,0.6666666666666666,0.5398613431497497,0.7779692372780057,66,44,22,31,19,21,22,13,0,1
"wisconsin_exoplanets-anthropic37,wisconsin_exoplanets-deepseek,wisconsin_exoplanets-llamaphi","2,1,1",0.6984126984126984,0.5697502308863991,0.8076894190779017,63,44,0.6363636363636364,0.5087394315103153,0.7513222169426668,66,42,20,30,17,22,24,12,2,2
"wisconsin_exoplanets-anthropic37,wisconsin_exoplanets-falcon,wisconsin_exoplanets-falcon10","2,1,1",0.6984126984126984,0.5697502308863991,0.8076894190779017,63,44,0.6363636363636364,0.5087394315103153,0.7513222169426668,66,42,16,24,13,16,28,18,6,8
"wisconsin_exoplanets-anthropic37,wisconsin_exoplanets-llamaphi,wisconsin_exoplanets-qwq","2,1,1",0.6984126984126984,0.5697502308863991,0.8076894190779017,63,44,0.6212121212121212,0.4933571772023376,0.7378154230046878,66,41,21,29,18,22,23,12,1,3
"wisconsin_exoplanets-anthropic37,wisconsin_exoplanets-gemma,wisconsin_exoplanets-openailong","2,1,4",0.6825396825396826,0.5531122629068814,0.7941510974941051,63,43,0.6515151515151515,0.5242397683271001,0.7647080305896783,66,43,21,29,19,20,22,14,1,3
"wisconsin_exoplanets-gemma,wisconsin_exoplanets-openaio1,wisconsin_exoplanets-qwq","1,2,1",0.6825396825396826,0.5531122629068814,0.7941510974941051,63,43,0.6060606060606061,0.47809031269657515,0.7241907640463761,66,40,14,13,12,7,29,27,8,19
"wisconsin_exoplanets-deepseek,wisconsin_exoplanets-openai4510,wisconsin_exoplanets-phi","1,2,1",0.6825396825396826,0.5531122629068814,0.7941510974941051,63,43,0.5909090909090909,0.46293656355858825,0.7104508976039902,66,39,11,12,9,7,32,27,11,20
"wisconsin_exoplanets-geminipro10,wisconsin_exoplanets-gemma,wisconsin_exoplanets-phi","3,1,1",0.6825396825396826,0.5531122629068814,0.7941510974941051,63,43,0.48484848484848486,0.3599107557499768,0.6111897347222226,66,32,11,8,9,10,32,24,11,24
"wisconsin_exoplanets-anthropic37,wisconsin_exoplanets-llama,wisconsin_exoplanets-qwq","2,2,1",0.6825396825396826,0.5531122629068814,0.7941510974941051,63,43,0.6515151515151515,0.5242397683271001,0.7647080305896783,66,43,15,22,13,13,28,21,7,10
"wisconsin_exoplanets-gemini,wisconsin_exoplanets-llama,wisconsin_exoplanets-phi","7,2,1",0.6825396825396826,0.5531122629068814,0.7941510974941051,63,43,0.6212121212121212,0.4933571772023376,0.7378154230046878,66,41,13,18,11,11,30,23,9,14
"wisconsin_exoplanets-gemma,wisconsin_exoplanets-openai4510,wisconsin_exoplanets-phi","1,2,1",0.6825396825396826,0.5531122629068814,0.7941510974941051,63,43,0.5151515151515151,0.3888102652777774,0.6400892442500232,66,34,12,9,10,9,31,25,10,23
"wisconsin_exoplanets-deepseek,wisconsin_exoplanets-openai10o1,wisconsin_exoplanets-openaio1","1,5,2",0.6825396825396826,0.5531122629068814,0.7941510974941051,63,43,0.6363636363636364,0.5087394315103153,0.7513222169426668,66,42,22,24,20,16,21,18,0,8
"wisconsin_exoplanets-deepseek,wisconsin_exoplanets-falcon10,wisconsin_exoplanets-openai4510","1,1,2",0.6825396825396826,0.5531122629068814,0.7941510974941051,63,43,0.7727272727272727,0.6530018980228203,0.8668572164845951,66,51,11,23,9,6,32,28,11,9
"wisconsin_exoplanets-gemma,wisconsin_exoplanets-llamaphi,wisconsin_exoplanets-openai4510","1,1,2",0.6825396825396826,0.5531122629068814,0.7941510974941051,63,43,0.5303030303030303,0.403420053441725,0.654378697236779,66,35,17,16,15,15,26,19,5,16
"wisconsin_exoplanets-gemini,wisconsin_exoplanets-llama,wisconsin_exoplanets-openai","7,2,6",0.6825396825396826,0.5531122629068814,0.7941510974941051,63,43,0.6515151515151515,0.5242397683271001,0.7647080305896783,66,43,19,28,17,19,24,15,3,4
"wisconsin_exoplanets-gemma,wisconsin_exoplanets-llama,wisconsin_exoplanets-openai4510","1,2,2",0.6825396825396826,0.5531122629068814,0.7941510974941051,63,43,0.5757575757575758,0.4478940377087594,0.6965980669616616,66,38,13,13,11,9,30,25,9,19
"wisconsin_exoplanets-gemini,wisconsin_exoplanets-llama,wisconsin_exoplanets-qwq","7,2,1",0.6825396825396826,0.5531122629068814,0.7941510974941051,63,43,0.5909090909090909,0.46293656355858825,0.7104508976039902,66,39,13,17,11,12,30,22,9,15
"wisconsin_exoplanets-deepseek,wisconsin_exoplanets-openai4510,wisconsin_exoplanets-qwq","1,2,1",0.6825396825396826,0.5531122629068814,0.7941510974941051,63,43,0.6212121212121212,0.4933571772023376,0.7378154230046878,66,41,11,13,9,6,32,28,11,19
"wisconsin_exoplanets-deepseek,wisconsin_exoplanets-falcon10,wisconsin_exoplanets-gemini10","1,1,2",0.6825396825396826,0.5531122629068814,0.7941510974941051,63,43,0.6818181818181818,0.5556078292305275,0.7911016327585585,66,45,11,17,9,6,32,28,11,15
"wisconsin_exoplanets-anthropic37,wisconsin_exoplanets-gemma,wisconsin_exoplanets-openai45","2,1,4",0.6825396825396826,0.5531122629068814,0.7941510974941051,63,43,0.6515151515151515,0.5242397683271001,0.7647080305896783,66,43,21,29,19,20,22,14,1,3
"wisconsin_exoplanets-geminipro,wisconsin_exoplanets-openai10o1,wisconsin_exoplanets-openailong","2,5,4",0.6825396825396826,0.5531122629068814,0.7941510974941051,63,43,0.5303030303030303,0.403420053441725,0.654378697236779,66,35,3,4,1,3,40,31,19,28
"wisconsin_exoplanets-deepseek,wisconsin_exoplanets-gemini,wisconsin_exoplanets-gemma","1,7,1",0.6825396825396826,0.5531122629068814,0.7941510974941051,63,43,0.6666666666666666,0.5398613431497497,0.7779692372780057,66,44,14,19,12,9,29,25,8,13
"wisconsin_exoplanets-anthropic37,wisconsin_exoplanets-falcon,wisconsin_exoplanets-llama","2,1,2",0.6825396825396826,0.5531122629068814,0.7941510974941051,63,43,0.6363636363636364,0.5087394315103153,0.7513222169426668,66,42,16,23,14,15,27,19,6,9
"wisconsin_exoplanets-anthropic10,wisconsin_exoplanets-gemma,wisconsin_exoplanets-openai4510","1,1,2",0.6825396825396826,0.5531122629068814,0.7941510974941051,63,43,0.5,0.37430716945155507,0.6256928305484449,66,33,10,9,8,10,33,24,12,23
"wisconsin_exoplanets-anthropic10,wisconsin_exoplanets-geminipro10,wisconsin_exoplanets-llama","1,3,2",0.6825396825396826,0.5531122629068814,0.7941510974941051,63,43,0.5303030303030303,0.403420053441725,0.654378697236779,66,35,9,14,7,13,34,21,13,18
"wisconsin_exoplanets-falcon,wisconsin_exoplanets-gemini,wisconsin_exoplanets-geminipro","1,7,2",0.6825396825396826,0.5531122629068814,0.7941510974941051,63,43,0.5303030303030303,0.403420053441725,0.654378697236779,66,35,7,6,5,5,36,29,15,26
"wisconsin_exoplanets-geminipro,wisconsin_exoplanets-geminipro10,wisconsin_exoplanets-openai10o1","2,3,5",0.6825396825396826,0.5531122629068814,0.7941510974941051,63,43,0.5909090909090909,0.46293656355858825,0.7104508976039902,66,39,5,6,3,1,38,33,17,26
"wisconsin_exoplanets-geminipro,wisconsin_exoplanets-geminipro10,wisconsin_exoplanets-qwq","2,3,1",0.6825396825396826,0.5531122629068814,0.7941510974941051,63,43,0.5909090909090909,0.46293656355858825,0.7104508976039902,66,39,4,6,2,1,39,33,18,26
"wisconsin_exoplanets-anthropic10,wisconsin_exoplanets-geminipro,wisconsin_exoplanets-llama","1,2,2",0.6825396825396826,0.5531122629068814,0.7941510974941051,63,43,0.5303030303030303,0.403420053441725,0.654378697236779,66,35,8,14,6,13,35,21,14,18
"wisconsin_exoplanets-geminipro,wisconsin_exoplanets-gemma,wisconsin_exoplanets-phi","2,1,1",0.6825396825396826,0.5531122629068814,0.7941510974941051,63,43,0.4696969696969697,0.345621302763221,0.5965799465582751,66,31,11,7,9,10,32,24,11,25
"wisconsin_exoplanets-deepseek,wisconsin_exoplanets-falcon10,wisconsin_exoplanets-geminipro10","1,1,3",0.6825396825396826,0.5531122629068814,0.7941510974941051,63,43,0.6515151515151515,0.5242397683271001,0.7647080305896783,66,43,11,16,9,7,32,27,11,16
"wisconsin_exoplanets-geminipro,wisconsin_exoplanets-llama,wisconsin_exoplanets-openai","2,2,6",0.6825396825396826,0.5531122629068814,0.7941510974941051,63,43,0.5909090909090909,0.46293656355858825,0.7104508976039902,66,39,15,21,13,16,28,18,7,11
"wisconsin_exoplanets-anthropic10,wisconsin_exoplanets-geminipro,wisconsin_exoplanets-geminipro10","1,2,3",0.6825396825396826,0.5531122629068814,0.7941510974941051,63,43,0.5757575757575758,0.4478940377087594,0.6965980669616616,66,38,4,5,2,1,39,33,18,27
"wisconsin_exoplanets-geminipro,wisconsin_exoplanets-llama,wisconsin_exoplanets-phi","2,2,1",0.6825396825396826,0.5531122629068814,0.7941510974941051,63,43,0.5454545454545454,0.4181368331466126,0.6685606183790747,66,36,11,10,9,8,32,26,11,22
"wisconsin_exoplanets-anthropic37,wisconsin_exoplanets-falcon10,wisconsin_exoplanets-qwq","2,1,1",0.6825396825396826,0.5531122629068814,0.7941510974941051,63,43,0.6515151515151515,0.5242397683271001,0.7647080305896783,66,43,16,23,14,14,27,20,6,9
"wisconsin_exoplanets-geminipro,wisconsin_exoplanets-llamaphi,wisconsin_exoplanets-openai10o1","2,1,5",0.6825396825396826,0.5531122629068814,0.7941510974941051,63,43,0.5454545454545454,0.4181368331466126,0.6685606183790747,66,36,4,6,2,4,39,30,18,26
"wisconsin_exoplanets-anthropic10,wisconsin_exoplanets-gemini10,wisconsin_exoplanets-llama","1,2,2",0.6825396825396826,0.5531122629068814,0.7941510974941051,63,43,0.5909090909090909,0.46293656355858825,0.7104508976039902,66,39,8,17,6,12,35,22,14,15
"wisconsin_exoplanets-anthropic37,wisconsin_exoplanets-gemma,wisconsin_exoplanets-openai10o1","2,1,5",0.6825396825396826,0.5531122629068814,0.7941510974941051,63,43,0.6515151515151515,0.5242397683271001,0.7647080305896783,66,43,20,27,18,18,23,16,2,5
"wisconsin_exoplanets-geminipro,wisconsin_exoplanets-openai10,wisconsin_exoplanets-openai45","2,5,4",0.6825396825396826,0.5531122629068814,0.7941510974941051,63,43,0.5606060606060606,0.43296119670295957,0.6826341362307495,66,37,3,4,1,1,40,33,19,28
"wisconsin_exoplanets-falcon,wisconsin_exoplanets-geminipro10,wisconsin_exoplanets-openai4510","1,3,2",0.6825396825396826,0.5531122629068814,0.7941510974941051,63,43,0.6515151515151515,0.5242397683271001,0.7647080305896783,66,43,5,10,3,1,38,33,17,22
"wisconsin_exoplanets-geminipro,wisconsin_exoplanets-openai10,wisconsin_exoplanets-openailong","2,5,4",0.6825396825396826,0.5531122629068814,0.7941510974941051,63,43,0.5454545454545454,0.4181368331466126,0.6685606183790747,66,36,3,4,1,2,40,32,19,28
"wisconsin_exoplanets-geminipro,wisconsin_exoplanets-openai10o1,wisconsin_exoplanets-openai45","2,5,4",0.6825396825396826,0.5531122629068814,0.7941510974941051,63,43,0.5454545454545454,0.4181368331466126,0.6685606183790747,66,36,4,4,2,2,39,32,18,28
"wisconsin_exoplanets-llama,wisconsin_exoplanets-openai10,wisconsin_exoplanets-openai4510","2,5,2",0.6825396825396826,0.5531122629068814,0.7941510974941051,63,43,0.6212121212121212,0.4933571772023376,0.7378154230046878,66,41,17,23,15,16,26,18,5,9
"wisconsin_exoplanets-anthropic37,wisconsin_exoplanets-openai,wisconsin_exoplanets-phi","2,6,1",0.6825396825396826,0.5531122629068814,0.7941510974941051,63,43,0.6666666666666666,0.5398613431497497,0.7779692372780057,66,44,22,30,20,20,21,14,0,2
"wisconsin_exoplanets-llama,wisconsin_exoplanets-openai4510,wisconsin_exoplanets-openailong","2,2,4",0.6825396825396826,0.5531122629068814,0.7941510974941051,63,43,0.6212121212121212,0.4933571772023376,0.7378154230046878,66,41,17,23,15,16,26,18,5,9
"wisconsin_exoplanets-anthropic,wisconsin_exoplanets-gemma,wisconsin_exoplanets-openai10o1","2,1,5",0.6825396825396826,0.5531122629068814,0.7941510974941051,63,43,0.6515151515151515,0.5242397683271001,0.7647080305896783,66,43,21,26,19,17,22,17,1,6
"wisconsin_exoplanets-falcon10,wisconsin_exoplanets-openai4510,wisconsin_exoplanets-phi","1,2,1",0.6825396825396826,0.5531122629068814,0.7941510974941051,63,43,0.6212121212121212,0.4933571772023376,0.7378154230046878,66,41,11,16,9,9,32,25,11,16
"wisconsin_exoplanets-falcon10,wisconsin_exoplanets-openailong,wisconsin_exoplanets-openaio1","1,4,2",0.6825396825396826,0.5531122629068814,0.7941510974941051,63,43,0.5909090909090909,0.46293656355858825,0.7104508976039902,66,39,21,25,19,20,22,14,1,7
"wisconsin_exoplanets-deepseek,wisconsin_exoplanets-geminipro10,wisconsin_exoplanets-llama","1,3,2",0.6825396825396826,0.5531122629068814,0.7941510974941051,63,43,0.6212121212121212,0.4933571772023376,0.7378154230046878,66,41,10,15,8,8,33,26,12,17
"wisconsin_exoplanets-deepseek,wisconsin_exoplanets-gemini10,wisconsin_exoplanets-openailong","1,2,4",0.6825396825396826,0.5531122629068814,0.7941510974941051,63,43,0.6666666666666666,0.5398613431497497,0.7779692372780057,66,44,15,22,13,12,28,22,7,10
"wisconsin_exoplanets-deepseek,wisconsin_exoplanets-geminipro10,wisconsin_exoplanets-gemma","1,3,1",0.6825396825396826,0.5531122629068814,0.7941510974941051,63,43,0.5757575757575758,0.4478940377087594,0.6965980669616616,66,38,10,11,8,7,33,27,12,21
"wisconsin_exoplanets-anthropic,wisconsin_exoplanets-falcon10,wisconsin_exoplanets-gemma","2,1,1",0.6825396825396826,0.5531122629068814,0.7941510974941051,63,43,0.6666666666666666,0.5398613431497497,0.7779692372780057,66,44,15,21,13,11,28,23,7,11
"wisconsin_exoplanets-anthropic3710,wisconsin_exoplanets-llama,wisconsin_exoplanets-openai10","5,2,5",0.6825396825396826,0.5531122629068814,0.7941510974941051,63,43,0.6818181818181818,0.5556078292305275,0.7911016327585585,66,45,20,30,18,19,23,15,2,2
"wisconsin_exoplanets-deepseek,wisconsin_exoplanets-gemini10,wisconsin_exoplanets-openai","1,2,6",0.6825396825396826,0.5531122629068814,0.7941510974941051,63,43,0.6363636363636364,0.5087394315103153,0.7513222169426668,66,42,16,21,14,13,27,21,6,11
"wisconsin_exoplanets-anthropic,wisconsin_exoplanets-gemini10,wisconsin_exoplanets-qwq","2,2,1",0.6825396825396826,0.5531122629068814,0.7941510974941051,63,43,0.7424242424242424,0.6199387593265298,0.8422336207426879,66,49,8,17,6,2,35,32,14,15
"wisconsin_exoplanets-deepseek,wisconsin_exoplanets-geminipro,wisconsin_exoplanets-phi","1,2,1",0.6825396825396826,0.5531122629068814,0.7941510974941051,63,43,0.5757575757575758,0.4478940377087594,0.6965980669616616,66,38,10,11,8,7,33,27,12,21
"wisconsin_exoplanets-anthropic,wisconsin_exoplanets-deepseek,wisconsin_exoplanets-openai","2,1,6",0.6825396825396826,0.5531122629068814,0.7941510974941051,63,43,0.6666666666666666,0.5398613431497497,0.7779692372780057,66,44,22,28,20,18,21,16,0,4
"wisconsin_exoplanets-anthropic,wisconsin_exoplanets-gemma,wisconsin_exoplanets-llamaphi","2,1,1",0.6825396825396826,0.5531122629068814,0.7941510974941051,63,43,0.6363636363636364,0.5087394315103153,0.7513222169426668,66,42,21,27,19,19,22,15,1,5
"wisconsin_exoplanets-anthropic,wisconsin_exoplanets-gemma,wisconsin_exoplanets-openai","2,1,6",0.6825396825396826,0.5531122629068814,0.7941510974941051,63,43,0.6666666666666666,0.5398613431497497,0.7779692372780057,66,44,21,28,19,18,22,16,1,4
"wisconsin_exoplanets-anthropic3710,wisconsin_exoplanets-falcon10,wisconsin_exoplanets-openai45","5,1,4",0.6825396825396826,0.5531122629068814,0.7941510974941051,63,43,0.6666666666666666,0.5398613431497497,0.7779692372780057,66,44,20,29,18,19,23,15,2,3
"wisconsin_exoplanets-deepseek,wisconsin_exoplanets-gemini10,wisconsin_exoplanets-llama","1,2,2",0.6825396825396826,0.5531122629068814,0.7941510974941051,63,43,0.6818181818181818,0.5556078292305275,0.7911016327585585,66,45,10,18,8,7,33,27,12,14
"wisconsin_exoplanets-falcon10,wisconsin_exoplanets-openai45,wisconsin_exoplanets-openaio1","1,4,2",0.6825396825396826,0.5531122629068814,0.7941510974941051,63,43,0.6060606060606061,0.47809031269657515,0.7241907640463761,66,40,21,25,19,19,22,15,1,7
"wisconsin_exoplanets-anthropic10,wisconsin_exoplanets-anthropic37,wisconsin_exoplanets-falcon10","1,2,1",0.6825396825396826,0.5531122629068814,0.7941510974941051,63,43,0.6212121212121212,0.4933571772023376,0.7378154230046878,66,41,16,24,14,17,27,17,6,8
"wisconsin_exoplanets-anthropic,wisconsin_exoplanets-llama,wisconsin_exoplanets-openai","2,2,6",0.6825396825396826,0.5531122629068814,0.7941510974941051,63,43,0.6515151515151515,0.5242397683271001,0.7647080305896783,66,43,21,27,19,18,22,16,1,5
"wisconsin_exoplanets-anthropic,wisconsin_exoplanets-llama,wisconsin_exoplanets-phi","2,2,1",0.6825396825396826,0.5531122629068814,0.7941510974941051,63,43,0.7575757575757576,0.6363888076622838,0.8546316735018541,66,50,15,26,13,10,28,24,7,6
"wisconsin_exoplanets-falcon10,wisconsin_exoplanets-geminipro,wisconsin_exoplanets-llama","1,2,2",0.6825396825396826,0.5531122629068814,0.7941510974941051,63,43,0.5757575757575758,0.4478940377087594,0.6965980669616616,66,38,9,14,7,10,34,24,13,18
"wisconsin_exoplanets-anthropic37,wisconsin_exoplanets-openailong,wisconsin_exoplanets-phi","2,4,1",0.6825396825396826,0.5531122629068814,0.7941510974941051,63,43,0.6818181818181818,0.5556078292305275,0.7911016327585585,66,45,22,29,20,18,21,16,0,3
"wisconsin_exoplanets-anthropic,wisconsin_exoplanets-anthropic10,wisconsin_exoplanets-gemma","2,1,1",0.6825396825396826,0.5531122629068814,0.7941510974941051,63,43,0.6363636363636364,0.5087394315103153,0.7513222169426668,66,42,15,19,13,11,28,23,7,13
"wisconsin_exoplanets-anthropic,wisconsin_exoplanets-phi,wisconsin_exoplanets-qwq","2,1,1",0.6825396825396826,0.5531122629068814,0.7941510974941051,63,43,0.6666666666666666,0.5398613431497497,0.7779692372780057,66,44,15,19,13,9,28,25,7,13
"wisconsin_exoplanets-deepseek,wisconsin_exoplanets-falcon10,wisconsin_exoplanets-gemini","1,1,7",0.6825396825396826,0.5531122629068814,0.7941510974941051,63,43,0.6515151515151515,0.5242397683271001,0.7647080305896783,66,43,15,19,13,10,28,24,7,13
"wisconsin_exoplanets-deepseek,wisconsin_exoplanets-gemini10,wisconsin_exoplanets-geminipro","1,2,2",0.6825396825396826,0.5531122629068814,0.7941510974941051,63,43,0.6212121212121212,0.4933571772023376,0.7378154230046878,66,41,2,8,0,1,41,33,20,24
"wisconsin_exoplanets-gemini10,wisconsin_exoplanets-geminipro,wisconsin_exoplanets-openai4510","2,2,2",0.6666666666666666,0.5366192448274891,0.7804625162677878,63,42,0.5606060606060606,0.43296119670295957,0.6826341362307495,66,37,1,3,0,0,41,34,21,29
"wisconsin_exoplanets-deepseek,wisconsin_exoplanets-geminipro,wisconsin_exoplanets-llama","1,2,2",0.6666666666666666,0.5366192448274891,0.7804625162677878,63,42,0.6060606060606061,0.47809031269657515,0.7241907640463761,66,40,10,14,9,8,32,26,12,18
"wisconsin_exoplanets-gemini,wisconsin_exoplanets-phi,wisconsin_exoplanets-qwq","7,1,1",0.6666666666666666,0.5366192448274891,0.7804625162677878,63,42,0.5606060606060606,0.43296119670295957,0.6826341362307495,66,37,13,13,12,10,29,24,9,19
"wisconsin_exoplanets-falcon,wisconsin_exoplanets-geminipro,wisconsin_exoplanets-geminipro10","1,2,3",0.6666666666666666,0.5366192448274891,0.7804625162677878,63,42,0.5757575757575758,0.4478940377087594,0.6965980669616616,66,38,3,5,2,1,39,33,19,27
"wisconsin_exoplanets-deepseek,wisconsin_exoplanets-falcon,wisconsin_exoplanets-openaio1","1,1,2",0.6666666666666666,0.5366192448274891,0.7804625162677878,63,42,0.6666666666666666,0.5398613431497497,0.7779692372780057,66,44,14,18,13,8,28,26,8,14
"wisconsin_exoplanets-anthropic3710,wisconsin_exoplanets-openai45,wisconsin_exoplanets-qwq","5,4,1",0.6666666666666666,0.5366192448274891,0.7804625162677878,63,42,0.6515151515151515,0.5242397683271001,0.7647080305896783,66,43,20,29,19,20,22,14,2,3
"wisconsin_exoplanets-anthropic37,wisconsin_exoplanets-falcon10,wisconsin_exoplanets-openai45","2,1,4",0.6666666666666666,0.5366192448274891,0.7804625162677878,63,42,0.6666666666666666,0.5398613431497497,0.7779692372780057,66,44,21,31,20,21,21,13,1,1
"wisconsin_exoplanets-falcon10,wisconsin_exoplanets-geminipro,wisconsin_exoplanets-gemma","1,2,1",0.6666666666666666,0.5366192448274891,0.7804625162677878,63,42,0.4696969696969697,0.345621302763221,0.5965799465582751,66,31,10,7,9,10,32,24,12,25
"wisconsin_exoplanets-falcon10,wisconsin_exoplanets-geminipro,wisconsin_exoplanets-phi","1,2,1",0.6666666666666666,0.5366192448274891,0.7804625162677878,63,42,0.5303030303030303,0.403420053441725,0.654378697236779,66,35,10,9,9,8,32,26,12,23
"wisconsin_exoplanets-anthropic37,wisconsin_exoplanets-falcon10,wisconsin_exoplanets-openai10","2,1,5",0.6666666666666666,0.5366192448274891,0.7804625162677878,63,42,0.6666666666666666,0.5398613431497497,0.7779692372780057,66,44,21,31,20,21,21,13,1,1
"wisconsin_exoplanets-anthropic3710,wisconsin_exoplanets-gemma,wisconsin_exoplanets-openai45","5,1,4",0.6666666666666666,0.5366192448274891,0.7804625162677878,63,42,0.696969696969697,0.5714834854226349,0.8041003533935258,66,46,20,30,19,18,22,16,2,2
"wisconsin_exoplanets-falcon10,wisconsin_exoplanets-openai10,wisconsin_exoplanets-openaio1","1,5,2",0.6666666666666666,0.5366192448274891,0.7804625162677878,63,42,0.6060606060606061,0.47809031269657515,0.7241907640463761,66,40,21,26,20,20,21,14,1,6
"wisconsin_exoplanets-anthropic37,wisconsin_exoplanets-falcon10,wisconsin_exoplanets-openailong","2,1,4",0.6666666666666666,0.5366192448274891,0.7804625162677878,63,42,0.6666666666666666,0.5398613431497497,0.7779692372780057,66,44,21,31,20,21,21,13,1,1
"wisconsin_exoplanets-anthropic37,wisconsin_exoplanets-llamaphi,wisconsin_exoplanets-phi","2,1,1",0.6666666666666666,0.5366192448274891,0.7804625162677878,63,42,0.6363636363636364,0.5087394315103153,0.7513222169426668,66,42,21,29,20,21,21,13,1,3
"wisconsin_exoplanets-gemini,wisconsin_exoplanets-gemma,wisconsin_exoplanets-llamaphi","7,1,1",0.6666666666666666,0.5366192448274891,0.7804625162677878,63,42,0.5454545454545454,0.4181368331466126,0.6685606183790747,66,36,19,22,18,20,23,14,3,10
"wisconsin_exoplanets-gemini10,wisconsin_exoplanets-geminipro10,wisconsin_exoplanets-qwq","2,3,1",0.6666666666666666,0.5366192448274891,0.7804625162677878,63,42,0.6515151515151515,0.5242397683271001,0.7647080305896783,66,43,2,9,1,0,40,34,20,23
"wisconsin_exoplanets-anthropic37,wisconsin_exoplanets-openai10,wisconsin_exoplanets-phi","2,5,1",0.6666666666666666,0.5366192448274891,0.7804625162677878,63,42,0.696969696969697,0.5714834854226349,0.8041003533935258,66,46,22,30,21,18,20,16,0,2
"wisconsin_exoplanets-anthropic37,wisconsin_exoplanets-openai10,wisconsin_exoplanets-qwq","2,5,1",0.6666666666666666,0.5366192448274891,0.7804625162677878,63,42,0.6212121212121212,0.4933571772023376,0.7378154230046878,66,41,21,29,20,22,21,12,1,3
"wisconsin_exoplanets-anthropic37,wisconsin_exoplanets-openai45,wisconsin_exoplanets-phi","2,4,1",0.6666666666666666,0.5366192448274891,0.7804625162677878,63,42,0.6818181818181818,0.5556078292305275,0.7911016327585585,66,45,22,29,21,18,20,16,0,3
"wisconsin_exoplanets-anthropic37,wisconsin_exoplanets-openai45,wisconsin_exoplanets-qwq","2,4,1",0.6666666666666666,0.5366192448274891,0.7804625162677878,63,42,0.6060606060606061,0.47809031269657515,0.7241907640463761,66,40,21,28,20,22,21,12,1,4
"wisconsin_exoplanets-anthropic37,wisconsin_exoplanets-openailong,wisconsin_exoplanets-qwq","2,4,1",0.6666666666666666,0.5366192448274891,0.7804625162677878,63,42,0.6060606060606061,0.47809031269657515,0.7241907640463761,66,40,21,28,20,22,21,12,1,4
"wisconsin_exoplanets-anthropic3710,wisconsin_exoplanets-falcon10,wisconsin_exoplanets-openai10","5,1,5",0.6666666666666666,0.5366192448274891,0.7804625162677878,63,42,0.6818181818181818,0.5556078292305275,0.7911016327585585,66,45,19,30,18,19,23,15,3,2
"wisconsin_exoplanets-anthropic3710,wisconsin_exoplanets-falcon10,wisconsin_exoplanets-openai10o1","5,1,5",0.6666666666666666,0.5366192448274891,0.7804625162677878,63,42,0.696969696969697,0.5714834854226349,0.8041003533935258,66,46,19,29,18,17,23,17,3,3
"wisconsin_exoplanets-anthropic3710,wisconsin_exoplanets-falcon10,wisconsin_exoplanets-openailong","5,1,4",0.6666666666666666,0.5366192448274891,0.7804625162677878,63,42,0.6666666666666666,0.5398613431497497,0.7779692372780057,66,44,19,29,18,19,23,15,3,3
"wisconsin_exoplanets-anthropic3710,wisconsin_exoplanets-falcon10,wisconsin_exoplanets-qwq","5,1,1",0.6666666666666666,0.5366192448274891,0.7804625162677878,63,42,0.696969696969697,0.5714834854226349,0.8041003533935258,66,46,14,22,13,10,28,24,8,10
"wisconsin_exoplanets-anthropic3710,wisconsin_exoplanets-gemma,wisconsin_exoplanets-openai10o1","5,1,5",0.6666666666666666,0.5366192448274891,0.7804625162677878,63,42,0.696969696969697,0.5714834854226349,0.8041003533935258,66,46,19,29,18,17,23,17,3,3
"wisconsin_exoplanets-gemini,wisconsin_exoplanets-gemma,wisconsin_exoplanets-openai","7,1,6",0.6666666666666666,0.5366192448274891,0.7804625162677878,63,42,0.5454545454545454,0.4181368331466126,0.6685606183790747,66,36,19,21,18,19,23,15,3,11
"wisconsin_exoplanets-anthropic3710,wisconsin_exoplanets-openai,wisconsin_exoplanets-phi","5,6,1",0.6666666666666666,0.5366192448274891,0.7804625162677878,63,42,0.6666666666666666,0.5398613431497497,0.7779692372780057,66,44,20,29,19,19,22,15,2,3
"wisconsin_exoplanets-gemini10,wisconsin_exoplanets-geminipro,wisconsin_exoplanets-qwq","2,2,1",0.6666666666666666,0.5366192448274891,0.7804625162677878,63,42,0.6212121212121212,0.4933571772023376,0.7378154230046878,66,41,2,7,1,0,40,34,20,25
"wisconsin_exoplanets-deepseek,wisconsin_exoplanets-geminipro,wisconsin_exoplanets-gemma","1,2,1",0.6666666666666666,0.5366192448274891,0.7804625162677878,63,42,0.5303030303030303,0.403420053441725,0.654378697236779,66,35,9,8,8,7,33,27,13,24
"wisconsin_exoplanets-geminipro,wisconsin_exoplanets-llama,wisconsin_exoplanets-llamaphi","2,2,1",0.6666666666666666,0.5366192448274891,0.7804625162677878,63,42,0.5606060606060606,0.43296119670295957,0.6826341362307495,66,37,15,21,14,18,27,16,7,11
"wisconsin_exoplanets-deepseek,wisconsin_exoplanets-openai,wisconsin_exoplanets-openai4510","1,6,2",0.6666666666666666,0.5366192448274891,0.7804625162677878,63,42,0.696969696969697,0.5714834854226349,0.8041003533935258,66,46,15,26,14,14,27,20,7,6
"wisconsin_exoplanets-anthropic10,wisconsin_exoplanets-deepseek,wisconsin_exoplanets-openai4510","1,1,2",0.6666666666666666,0.5366192448274891,0.7804625162677878,63,42,0.696969696969697,0.5714834854226349,0.8041003533935258,66,46,10,20,9,8,32,26,12,12
"wisconsin_exoplanets-anthropic10,wisconsin_exoplanets-deepseek,wisconsin_exoplanets-gemini","1,1,7",0.6666666666666666,0.5366192448274891,0.7804625162677878,63,42,0.5909090909090909,0.46293656355858825,0.7104508976039902,66,39,13,18,12,13,29,21,9,14
"wisconsin_exoplanets-anthropic10,wisconsin_exoplanets-anthropic3710,wisconsin_exoplanets-qwq","1,5,1",0.6666666666666666,0.5366192448274891,0.7804625162677878,63,42,0.6060606060606061,0.47809031269657515,0.7241907640463761,66,40,12,20,11,14,30,20,10,12
"wisconsin_exoplanets-anthropic,wisconsin_exoplanets-deepseek,wisconsin_exoplanets-openai45","2,1,4",0.6666666666666666,0.5366192448274891,0.7804625162677878,63,42,0.696969696969697,0.5714834854226349,0.8041003533935258,66,46,22,28,21,16,20,18,0,4
"wisconsin_exoplanets-anthropic,wisconsin_exoplanets-deepseek,wisconsin_exoplanets-openailong","2,1,4",0.6666666666666666,0.5366192448274891,0.7804625162677878,63,42,0.6818181818181818,0.5556078292305275,0.7911016327585585,66,45,22,28,21,17,20,17,0,4
"wisconsin_exoplanets-deepseek,wisconsin_exoplanets-geminipro10,wisconsin_exoplanets-openai45","1,3,4",0.6666666666666666,0.5366192448274891,0.7804625162677878,63,42,0.6666666666666666,0.5398613431497497,0.7779692372780057,66,44,16,22,15,12,26,22,6,10
"wisconsin_exoplanets-llama,wisconsin_exoplanets-openai4510,wisconsin_exoplanets-qwq","2,2,1",0.6666666666666666,0.5366192448274891,0.7804625162677878,63,42,0.6060606060606061,0.47809031269657515,0.7241907640463761,66,40,11,17,10,11,31,23,11,15
"wisconsin_exoplanets-anthropic10,wisconsin_exoplanets-anthropic37,wisconsin_exoplanets-openai","1,2,6",0.6666666666666666,0.5366192448274891,0.7804625162677878,63,42,0.6060606060606061,0.47809031269657515,0.7241907640463761,66,40,22,30,21,24,20,10,0,2
"wisconsin_exoplanets-deepseek,wisconsin_exoplanets-gemini10,wisconsin_exoplanets-openai10o1","1,2,5",0.6666666666666666,0.5366192448274891,0.7804625162677878,63,42,0.7121212121212122,0.5874932401392494,0.816959774581892,66,47,15,23,14,10,27,24,7,9
"wisconsin_exoplanets-geminipro10,wisconsin_exoplanets-gemma,wisconsin_exoplanets-llama","3,1,2",0.6666666666666666,0.5366192448274891,0.7804625162677878,63,42,0.5,0.37430716945155507,0.6256928305484449,66,33,11,9,10,10,31,24,11,23
"wisconsin_exoplanets-anthropic,wisconsin_exoplanets-falcon10,wisconsin_exoplanets-llamaphi","2,1,1",0.6666666666666666,0.5366192448274891,0.7804625162677878,63,42,0.6818181818181818,0.5556078292305275,0.7911016327585585,66,45,21,29,20,18,21,16,1,3
"wisconsin_exoplanets-anthropic,wisconsin_exoplanets-falcon10,wisconsin_exoplanets-openai","2,1,6",0.6666666666666666,0.5366192448274891,0.7804625162677878,63,42,0.6818181818181818,0.5556078292305275,0.7911016327585585,66,45,21,28,20,17,21,17,1,4
"wisconsin_exoplanets-anthropic,wisconsin_exoplanets-openai,wisconsin_exoplanets-qwq","2,6,1",0.6666666666666666,0.5366192448274891,0.7804625162677878,63,42,0.6666666666666666,0.5398613431497497,0.7779692372780057,66,44,20,26,19,16,22,18,2,6
"wisconsin_exoplanets-anthropic,wisconsin_exoplanets-llamaphi,wisconsin_exoplanets-qwq","2,1,1",0.6666666666666666,0.5366192448274891,0.7804625162677878,63,42,0.6363636363636364,0.5087394315103153,0.7513222169426668,66,42,20,26,19,18,22,16,2,6
"wisconsin_exoplanets-anthropic,wisconsin_exoplanets-llama,wisconsin_exoplanets-qwq","2,2,1",0.6666666666666666,0.5366192448274891,0.7804625162677878,63,42,0.6818181818181818,0.5556078292305275,0.7911016327585585,66,45,15,21,14,10,27,24,7,11
"wisconsin_exoplanets-deepseek,wisconsin_exoplanets-gemini10,wisconsin_exoplanets-llamaphi","1,2,1",0.6666666666666666,0.5366192448274891,0.7804625162677878,63,42,0.6363636363636364,0.5087394315103153,0.7513222169426668,66,42,15,21,14,13,27,21,7,11
"wisconsin_exoplanets-anthropic,wisconsin_exoplanets-gemma,wisconsin_exoplanets-llama","2,1,2",0.6666666666666666,0.5366192448274891,0.7804625162677878,63,42,0.6666666666666666,0.5398613431497497,0.7779692372780057,66,44,16,20,15,10,26,24,6,12
"wisconsin_exoplanets-anthropic,wisconsin_exoplanets-gemma,wisconsin_exoplanets-openailong","2,1,4",0.6666666666666666,0.5366192448274891,0.7804625162677878,63,42,0.6666666666666666,0.5398613431497497,0.7779692372780057,66,44,21,27,20,17,21,17,1,5
"wisconsin_exoplanets-geminipro10,wisconsin_exoplanets-llama,wisconsin_exoplanets-openai","3,2,6",0.6666666666666666,0.5366192448274891,0.7804625162677878,63,42,0.6060606060606061,0.47809031269657515,0.7241907640463761,66,40,16,22,15,16,26,18,6,10
"wisconsin_exoplanets-deepseek,wisconsin_exoplanets-openai45,wisconsin_exoplanets-openai4510","1,4,2",0.6666666666666666,0.5366192448274891,0.7804625162677878,63,42,0.7121212121212122,0.5874932401392494,0.816959774581892,66,47,15,26,14,13,27,21,7,6
"wisconsin_exoplanets-gemini10,wisconsin_exoplanets-llama,wisconsin_exoplanets-phi","2,2,1",0.6666666666666666,0.5366192448274891,0.7804625162677878,63,42,0.6060606060606061,0.47809031269657515,0.7241907640463761,66,40,9,14,8,8,33,26,13,18
"wisconsin_exoplanets-anthropic,wisconsin_exoplanets-deepseek,wisconsin_exoplanets-llamaphi","2,1,1",0.6666666666666666,0.5366192448274891,0.7804625162677878,63,42,0.6666666666666666,0.5398613431497497,0.7779692372780057,66,44,21,28,20,18,21,16,1,4
"wisconsin_exoplanets-falcon,wisconsin_exoplanets-gemini10,wisconsin_exoplanets-geminipro","1,2,2",0.6666666666666666,0.5366192448274891,0.7804625162677878,63,42,0.6212121212121212,0.4933571772023376,0.7378154230046878,66,41,1,7,0,0,41,34,21,25
"wisconsin_exoplanets-anthropic,wisconsin_exoplanets-anthropic10,wisconsin_exoplanets-deepseek","2,1,1",0.6666666666666666,0.5366192448274891,0.7804625162677878,63,42,0.7272727272727273,0.6036427957562946,0.8296733838204806,66,48,16,23,15,9,26,25,6,9
"wisconsin_exoplanets-anthropic,wisconsin_exoplanets-anthropic10,wisconsin_exoplanets-falcon10","2,1,1",0.6666666666666666,0.5366192448274891,0.7804625162677878,63,42,0.6363636363636364,0.5087394315103153,0.7513222169426668,66,42,16,21,15,13,26,21,6,11
"wisconsin_exoplanets-gemini10,wisconsin_exoplanets-llama,wisconsin_exoplanets-llamaphi","2,2,1",0.6666666666666666,0.5366192448274891,0.7804625162677878,63,42,0.6212121212121212,0.4933571772023376,0.7378154230046878,66,41,15,24,14,17,27,17,7,8
"wisconsin_exoplanets-deepseek,wisconsin_exoplanets-geminipro,wisconsin_exoplanets-openai45","1,2,4",0.6666666666666666,0.5366192448274891,0.7804625162677878,63,42,0.6666666666666666,0.5398613431497497,0.7779692372780057,66,44,15,22,14,12,27,22,7,10
"wisconsin_exoplanets-deepseek,wisconsin_exoplanets-gemini,wisconsin_exoplanets-llama","1,7,2",0.6666666666666666,0.5366192448274891,0.7804625162677878,63,42,0.6363636363636364,0.5087394315103153,0.7513222169426668,66,42,13,22,12,14,29,20,9,10
"wisconsin_exoplanets-gemini10,wisconsin_exoplanets-llama,wisconsin_exoplanets-openai10o1","2,2,5",0.6666666666666666,0.5366192448274891,0.7804625162677878,63,42,0.6212121212121212,0.4933571772023376,0.7378154230046878,66,41,15,22,14,15,27,19,7,10
"wisconsin_exoplanets-gemini10,wisconsin_exoplanets-llama,wisconsin_exoplanets-openai45","2,2,4",0.6666666666666666,0.5366192448274891,0.7804625162677878,63,42,0.6515151515151515,0.5242397683271001,0.7647080305896783,66,43,16,24,15,15,26,19,6,8
"wisconsin_exoplanets-anthropic,wisconsin_exoplanets-deepseek,wisconsin_exoplanets-gemma","2,1,1",0.6666666666666666,0.5366192448274891,0.7804625162677878,63,42,0.7272727272727273,0.6036427957562946,0.8296733838204806,66,48,16,22,15,8,26,26,6,10
"wisconsin_exoplanets-anthropic10,wisconsin_exoplanets-falcon10,wisconsin_exoplanets-openaio1","1,1,2",0.6666666666666666,0.5366192448274891,0.7804625162677878,63,42,0.5757575757575758,0.4478940377087594,0.6965980669616616,66,38,15,17,14,13,27,21,7,15
"wisconsin_exoplanets-anthropic10,wisconsin_exoplanets-llama,wisconsin_exoplanets-openai4510","1,2,2",0.6666666666666666,0.5366192448274891,0.7804625162677878,63,42,0.6212121212121212,0.4933571772023376,0.7378154230046878,66,41,8,19,7,12,34,22,14,13
"wisconsin_exoplanets-anthropic,wisconsin_exoplanets-gemma,wisconsin_exoplanets-openai45","2,1,4",0.6666666666666666,0.5366192448274891,0.7804625162677878,63,42,0.6666666666666666,0.5398613431497497,0.7779692372780057,66,44,21,27,20,17,21,17,1,5
"wisconsin_exoplanets-geminipro,wisconsin_exoplanets-llamaphi,wisconsin_exoplanets-openai10","2,1,5",0.6666666666666666,0.5366192448274891,0.7804625162677878,63,42,0.5757575757575758,0.4478940377087594,0.6965980669616616,66,38,4,8,3,4,38,30,18,24
"wisconsin_exoplanets-geminipro,wisconsin_exoplanets-openai10,wisconsin_exoplanets-openai10o1","2,5,5",0.6666666666666666,0.5366192448274891,0.7804625162677878,63,42,0.5454545454545454,0.4181368331466126,0.6685606183790747,66,36,3,5,2,3,39,31,19,27
"wisconsin_exoplanets-anthropic3710,wisconsin_exoplanets-openai10,wisconsin_exoplanets-qwq","5,5,1",0.6507936507936508,0.5202661770886656,0.7666294186329925,63,41,0.6515151515151515,0.5242397683271001,0.7647080305896783,66,43,19,29,19,20,22,14,3,3
"wisconsin_exoplanets-anthropic3710,wisconsin_exoplanets-openai10o1,wisconsin_exoplanets-qwq","5,5,1",0.6507936507936508,0.5202661770886656,0.7666294186329925,63,41,0.6666666666666666,0.5398613431497497,0.7779692372780057,66,44,20,28,20,18,21,16,2,4
"wisconsin_exoplanets-deepseek,wisconsin_exoplanets-falcon,wisconsin_exoplanets-gemini","1,1,7",0.6507936507936508,0.5202661770886656,0.7666294186329925,63,41,0.6515151515151515,0.5242397683271001,0.7647080305896783,66,43,13,19,13,10,28,24,9,13
"wisconsin_exoplanets-anthropic3710,wisconsin_exoplanets-openailong,wisconsin_exoplanets-qwq","5,4,1",0.6507936507936508,0.5202661770886656,0.7666294186329925,63,41,0.6515151515151515,0.5242397683271001,0.7647080305896783,66,43,19,29,19,20,22,14,3,3
"wisconsin_exoplanets-anthropic,wisconsin_exoplanets-deepseek,wisconsin_exoplanets-openai10","2,1,5",0.6507936507936508,0.5202661770886656,0.7666294186329925,63,41,0.696969696969697,0.5714834854226349,0.8041003533935258,66,46,21,29,21,17,20,17,1,3
"wisconsin_exoplanets-anthropic,wisconsin_exoplanets-falcon10,wisconsin_exoplanets-openai45","2,1,4",0.6507936507936508,0.5202661770886656,0.7666294186329925,63,41,0.696969696969697,0.5714834854226349,0.8041003533935258,66,46,21,29,21,17,20,17,1,3
"wisconsin_exoplanets-falcon10,wisconsin_exoplanets-llamaphi,wisconsin_exoplanets-openaio1","1,1,2",0.6507936507936508,0.5202661770886656,0.7666294186329925,63,41,0.6212121212121212,0.4933571772023376,0.7378154230046878,66,41,21,26,21,19,20,15,1,6
"wisconsin_exoplanets-anthropic,wisconsin_exoplanets-deepseek,wisconsin_exoplanets-openai10o1","2,1,5",0.6507936507936508,0.5202661770886656,0.7666294186329925,63,41,0.7121212121212122,0.5874932401392494,0.816959774581892,66,47,21,28,21,15,20,19,1,4
"wisconsin_exoplanets-anthropic3710,wisconsin_exoplanets-gemma,wisconsin_exoplanets-openailong","5,1,4",0.6507936507936508,0.5202661770886656,0.7666294186329925,63,41,0.696969696969697,0.5714834854226349,0.8041003533935258,66,46,19,30,19,18,22,16,3,2
"wisconsin_exoplanets-anthropic,wisconsin_exoplanets-falcon10,wisconsin_exoplanets-openailong","2,1,4",0.6507936507936508,0.5202661770886656,0.7666294186329925,63,41,0.696969696969697,0.5714834854226349,0.8041003533935258,66,46,21,29,21,17,20,17,1,3
"wisconsin_exoplanets-anthropic,wisconsin_exoplanets-falcon10,wisconsin_exoplanets-qwq","2,1,1",0.6507936507936508,0.5202661770886656,0.7666294186329925,63,41,0.696969696969697,0.5714834854226349,0.8041003533935258,66,46,15,21,15,9,26,25,7,11
"wisconsin_exoplanets-anthropic,wisconsin_exoplanets-gemma,wisconsin_exoplanets-openai10","2,1,5",0.6507936507936508,0.5202661770886656,0.7666294186329925,63,41,0.6818181818181818,0.5556078292305275,0.7911016327585585,66,45,21,28,21,17,20,17,1,4
"wisconsin_exoplanets-falcon10,wisconsin_exoplanets-openai,wisconsin_exoplanets-openaio1","1,6,2",0.6507936507936508,0.5202661770886656,0.7666294186329925,63,41,0.6212121212121212,0.4933571772023376,0.7378154230046878,66,41,21,26,21,19,20,15,1,6
"wisconsin_exoplanets-falcon10,wisconsin_exoplanets-openai,wisconsin_exoplanets-openai4510","1,6,2",0.6507936507936508,0.5202661770886656,0.7666294186329925,63,41,0.6363636363636364,0.5087394315103153,0.7513222169426668,66,42,16,24,16,16,25,18,6,8
"wisconsin_exoplanets-gemini10,wisconsin_exoplanets-gemma,wisconsin_exoplanets-llama","2,1,2",0.6507936507936508,0.5202661770886656,0.7666294186329925,63,41,0.5454545454545454,0.4181368331466126,0.6685606183790747,66,36,10,11,10,9,31,25,12,21
"wisconsin_exoplanets-anthropic,wisconsin_exoplanets-gemma,wisconsin_exoplanets-qwq","2,1,1",0.6507936507936508,0.5202661770886656,0.7666294186329925,63,41,0.696969696969697,0.5714834854226349,0.8041003533935258,66,46,14,18,14,6,27,28,8,14
"wisconsin_exoplanets-gemini,wisconsin_exoplanets-llama,wisconsin_exoplanets-llamaphi","7,2,1",0.6507936507936508,0.5202661770886656,0.7666294186329925,63,41,0.6060606060606061,0.47809031269657515,0.7241907640463761,66,40,18,27,18,21,23,13,4,5
"wisconsin_exoplanets-gemini10,wisconsin_exoplanets-gemma,wisconsin_exoplanets-openai","2,1,6",0.6507936507936508,0.5202661770886656,0.7666294186329925,63,41,0.5303030303030303,0.403420053441725,0.654378697236779,66,35,14,15,14,14,27,20,8,17
"wisconsin_exoplanets-gemini10,wisconsin_exoplanets-gemma,wisconsin_exoplanets-phi","2,1,1",0.6507936507936508,0.5202661770886656,0.7666294186329925,63,41,0.5151515151515151,0.3888102652777774,0.6400892442500232,66,34,9,9,9,9,32,25,13,23
"wisconsin_exoplanets-anthropic10,wisconsin_exoplanets-openaio1,wisconsin_exoplanets-qwq","1,2,1",0.6507936507936508,0.5202661770886656,0.7666294186329925,63,41,0.5606060606060606,0.43296119670295957,0.6826341362307495,66,37,14,16,14,13,27,21,8,16
"wisconsin_exoplanets-gemini10,wisconsin_exoplanets-llama,wisconsin_exoplanets-openailong","2,2,4",0.6507936507936508,0.5202661770886656,0.7666294186329925,63,41,0.6363636363636364,0.5087394315103153,0.7513222169426668,66,42,15,24,15,16,26,18,7,8
"wisconsin_exoplanets-anthropic10,wisconsin_exoplanets-geminipro10,wisconsin_exoplanets-gemma","1,3,1",0.6507936507936508,0.5202661770886656,0.7666294186329925,63,41,0.48484848484848486,0.3599107557499768,0.6111897347222226,66,32,9,8,9,10,32,24,13,24
"wisconsin_exoplanets-anthropic37,wisconsin_exoplanets-falcon10,wisconsin_exoplanets-openai10o1","2,1,5",0.6507936507936508,0.5202661770886656,0.7666294186329925,63,41,0.6666666666666666,0.5398613431497497,0.7779692372780057,66,44,20,30,20,20,21,14,2,2
"wisconsin_exoplanets-geminipro,wisconsin_exoplanets-gemma,wisconsin_exoplanets-openai","2,1,6",0.6507936507936508,0.5202661770886656,0.7666294186329925,63,41,0.4696969696969697,0.345621302763221,0.5965799465582751,66,31,15,11,15,14,26,20,7,21
"wisconsin_exoplanets-geminipro,wisconsin_exoplanets-llama,wisconsin_exoplanets-openai45","2,2,4",0.6507936507936508,0.5202661770886656,0.7666294186329925,63,41,0.6060606060606061,0.47809031269657515,0.7241907640463761,66,40,15,22,15,16,26,18,7,10
"wisconsin_exoplanets-anthropic37,wisconsin_exoplanets-gemma,wisconsin_exoplanets-openai10","2,1,5",0.6507936507936508,0.5202661770886656,0.7666294186329925,63,41,0.6515151515151515,0.5242397683271001,0.7647080305896783,66,43,20,29,20,20,21,14,2,3
"wisconsin_exoplanets-geminipro10,wisconsin_exoplanets-llama,wisconsin_exoplanets-llamaphi","3,2,1",0.6507936507936508,0.5202661770886656,0.7666294186329925,63,41,0.5757575757575758,0.4478940377087594,0.6965980669616616,66,38,16,22,16,18,25,16,6,10
"wisconsin_exoplanets-gemma,wisconsin_exoplanets-llamaphi,wisconsin_exoplanets-openai","1,1,6",0.6507936507936508,0.5202661770886656,0.7666294186329925,63,41,0.4393939393939394,0.31736586376925047,0.5670388032970404,66,29,14,10,14,15,27,19,8,22
"wisconsin_exoplanets-llama,wisconsin_exoplanets-llamaphi,wisconsin_exoplanets-openai","2,1,6",0.6507936507936508,0.5202661770886656,0.7666294186329925,63,41,0.5606060606060606,0.43296119670295957,0.6826341362307495,66,37,14,20,14,17,27,17,8,12
"wisconsin_exoplanets-anthropic,wisconsin_exoplanets-llama,wisconsin_exoplanets-llamaphi","2,2,1",0.6507936507936508,0.5202661770886656,0.7666294186329925,63,41,0.6363636363636364,0.5087394315103153,0.7513222169426668,66,42,20,28,20,20,21,14,2,4
"wisconsin_exoplanets-anthropic10,wisconsin_exoplanets-anthropic3710,wisconsin_exoplanets-phi","1,5,1",0.6507936507936508,0.5202661770886656,0.7666294186329925,63,41,0.6818181818181818,0.5556078292305275,0.7911016327585585,66,45,13,25,13,14,28,20,9,7
"wisconsin_exoplanets-anthropic10,wisconsin_exoplanets-anthropic3710,wisconsin_exoplanets-falcon10","1,5,1",0.6507936507936508,0.5202661770886656,0.7666294186329925,63,41,0.6363636363636364,0.5087394315103153,0.7513222169426668,66,42,15,23,15,15,26,19,7,9
"wisconsin_exoplanets-anthropic10,wisconsin_exoplanets-anthropic37,wisconsin_exoplanets-qwq","1,2,1",0.6507936507936508,0.5202661770886656,0.7666294186329925,63,41,0.6060606060606061,0.47809031269657515,0.7241907640463761,66,40,13,20,13,14,28,20,9,12
"wisconsin_exoplanets-anthropic10,wisconsin_exoplanets-anthropic37,wisconsin_exoplanets-phi","1,2,1",0.6507936507936508,0.5202661770886656,0.7666294186329925,63,41,0.6363636363636364,0.5087394315103153,0.7513222169426668,66,42,15,24,15,16,26,18,7,8
"wisconsin_exoplanets-anthropic37,wisconsin_exoplanets-openai10o1,wisconsin_exoplanets-phi","2,5,1",0.6507936507936508,0.5202661770886656,0.7666294186329925,63,41,0.696969696969697,0.5714834854226349,0.8041003533935258,66,46,22,29,22,17,19,17,0,3
"wisconsin_exoplanets-anthropic37,wisconsin_exoplanets-openai10o1,wisconsin_exoplanets-qwq","2,5,1",0.6507936507936508,0.5202661770886656,0.7666294186329925,63,41,0.6212121212121212,0.4933571772023376,0.7378154230046878,66,41,21,28,21,21,20,13,1,4
"wisconsin_exoplanets-gemini10,wisconsin_exoplanets-gemma,wisconsin_exoplanets-llamaphi","2,1,1",0.6507936507936508,0.5202661770886656,0.7666294186329925,63,41,0.5,0.37430716945155507,0.6256928305484449,66,33,14,14,14,15,27,19,8,18
"wisconsin_exoplanets-anthropic,wisconsin_exoplanets-openai45,wisconsin_exoplanets-qwq","2,4,1",0.6507936507936508,0.5202661770886656,0.7666294186329925,63,41,0.6515151515151515,0.5242397683271001,0.7647080305896783,66,43,20,26,20,17,21,17,2,6
"wisconsin_exoplanets-anthropic,wisconsin_exoplanets-llama,wisconsin_exoplanets-openailong","2,2,4",0.6507936507936508,0.5202661770886656,0.7666294186329925,63,41,0.6666666666666666,0.5398613431497497,0.7779692372780057,66,44,21,29,21,19,20,15,1,3
"wisconsin_exoplanets-anthropic,wisconsin_exoplanets-llama,wisconsin_exoplanets-openai45","2,2,4",0.6507936507936508,0.5202661770886656,0.7666294186329925,63,41,0.6666666666666666,0.5398613431497497,0.7779692372780057,66,44,21,29,21,19,20,15,1,3
"wisconsin_exoplanets-anthropic3710,wisconsin_exoplanets-falcon,wisconsin_exoplanets-openai","5,1,6",0.6507936507936508,0.5202661770886656,0.7666294186329925,63,41,0.6363636363636364,0.5087394315103153,0.7513222169426668,66,42,21,27,21,19,20,15,1,5
"wisconsin_exoplanets-anthropic,wisconsin_exoplanets-openailong,wisconsin_exoplanets-qwq","2,4,1",0.6507936507936508,0.5202661770886656,0.7666294186329925,63,41,0.6515151515151515,0.5242397683271001,0.7647080305896783,66,43,20,26,20,17,21,17,2,6
"wisconsin_exoplanets-deepseek,wisconsin_exoplanets-geminipro10,wisconsin_exoplanets-openailong","1,3,4",0.6507936507936508,0.5202661770886656,0.7666294186329925,63,41,0.6666666666666666,0.5398613431497497,0.7779692372780057,66,44,15,22,15,12,26,22,7,10
"wisconsin_exoplanets-deepseek,wisconsin_exoplanets-llamaphi,wisconsin_exoplanets-openai","1,1,6",0.6507936507936508,0.5202661770886656,0.7666294186329925,63,41,0.6363636363636364,0.5087394315103153,0.7513222169426668,66,42,14,21,14,13,27,21,8,11
"wisconsin_exoplanets-falcon,wisconsin_exoplanets-falcon10,wisconsin_exoplanets-openaio1","1,1,2",0.6507936507936508,0.5202661770886656,0.7666294186329925,63,41,0.6212121212121212,0.4933571772023376,0.7378154230046878,66,41,15,19,15,12,26,22,7,13
"wisconsin_exoplanets-deepseek,wisconsin_exoplanets-geminipro10,wisconsin_exoplanets-llamaphi","1,3,1",0.6507936507936508,0.5202661770886656,0.7666294186329925,63,41,0.6515151515151515,0.5242397683271001,0.7647080305896783,66,43,16,22,16,13,25,21,6,10
"wisconsin_exoplanets-deepseek,wisconsin_exoplanets-gemini10,wisconsin_exoplanets-phi","1,2,1",0.6507936507936508,0.5202661770886656,0.7666294186329925,63,41,0.6515151515151515,0.5242397683271001,0.7647080305896783,66,43,8,15,8,6,33,28,14,17
"wisconsin_exoplanets-deepseek,wisconsin_exoplanets-gemini10,wisconsin_exoplanets-openai10","1,2,5",0.6507936507936508,0.5202661770886656,0.7666294186329925,63,41,0.6818181818181818,0.5556078292305275,0.7911016327585585,66,45,14,23,14,12,27,22,8,9
"wisconsin_exoplanets-deepseek,wisconsin_exoplanets-geminipro,wisconsin_exoplanets-openailong","1,2,4",0.6507936507936508,0.5202661770886656,0.7666294186329925,63,41,0.6666666666666666,0.5398613431497497,0.7779692372780057,66,44,14,22,14,12,27,22,8,10
"wisconsin_exoplanets-deepseek,wisconsin_exoplanets-openai45,wisconsin_exoplanets-openailong","1,4,4",0.6507936507936508,0.5202661770886656,0.7666294186329925,63,41,0.6515151515151515,0.5242397683271001,0.7647080305896783,66,43,13,21,13,12,28,22,9,11
"wisconsin_exoplanets-deepseek,wisconsin_exoplanets-gemini,wisconsin_exoplanets-openailong","1,7,4",0.6507936507936508,0.5202661770886656,0.7666294186329925,63,41,0.6212121212121212,0.4933571772023376,0.7378154230046878,66,41,20,24,20,17,21,17,2,8
"wisconsin_exoplanets-deepseek,wisconsin_exoplanets-openai4510,wisconsin_exoplanets-openailong","1,2,4",0.6507936507936508,0.5202661770886656,0.7666294186329925,63,41,0.7121212121212122,0.5874932401392494,0.816959774581892,66,47,14,26,14,13,27,21,8,6
"wisconsin_exoplanets-deepseek,wisconsin_exoplanets-geminipro10,wisconsin_exoplanets-openai","1,3,6",0.6507936507936508,0.5202661770886656,0.7666294186329925,63,41,0.6363636363636364,0.5087394315103153,0.7513222169426668,66,42,16,21,16,13,25,21,6,11
"wisconsin_exoplanets-deepseek,wisconsin_exoplanets-gemini,wisconsin_exoplanets-openai","1,7,6",0.6507936507936508,0.5202661770886656,0.7666294186329925,63,41,0.6060606060606061,0.47809031269657515,0.7241907640463761,66,40,20,24,20,18,21,16,2,8
"wisconsin_exoplanets-falcon,wisconsin_exoplanets-gemma,wisconsin_exoplanets-openai4510","1,1,2",0.6507936507936508,0.5202661770886656,0.7666294186329925,63,41,0.5757575757575758,0.4478940377087594,0.6965980669616616,66,38,10,12,10,8,31,26,12,20
"wisconsin_exoplanets-deepseek,wisconsin_exoplanets-gemini,wisconsin_exoplanets-openai10o1","1,7,5",0.6507936507936508,0.5202661770886656,0.7666294186329925,63,41,0.6818181818181818,0.5556078292305275,0.7911016327585585,66,45,20,25,20,14,21,20,2,7
"wisconsin_exoplanets-deepseek,wisconsin_exoplanets-gemini,wisconsin_exoplanets-openai45","1,7,4",0.6507936507936508,0.5202661770886656,0.7666294186329925,63,41,0.6212121212121212,0.4933571772023376,0.7378154230046878,66,41,20,24,20,17,21,17,2,8
"wisconsin_exoplanets-falcon,wisconsin_exoplanets-gemini10,wisconsin_exoplanets-geminipro10","1,2,3",0.6507936507936508,0.5202661770886656,0.7666294186329925,63,41,0.6363636363636364,0.5087394315103153,0.7513222169426668,66,42,2,8,2,0,39,34,20,24
"wisconsin_exoplanets-deepseek,wisconsin_exoplanets-geminipro,wisconsin_exoplanets-openai","1,2,6",0.6507936507936508,0.5202661770886656,0.7666294186329925,63,41,0.6363636363636364,0.5087394315103153,0.7513222169426668,66,42,15,21,15,13,26,21,7,11
"wisconsin_exoplanets-deepseek,wisconsin_exoplanets-geminipro,wisconsin_exoplanets-llamaphi","1,2,1",0.6507936507936508,0.5202661770886656,0.7666294186329925,63,41,0.6515151515151515,0.5242397683271001,0.7647080305896783,66,43,15,22,15,13,26,21,7,10
"wisconsin_exoplanets-falcon,wisconsin_exoplanets-llama,wisconsin_exoplanets-openai4510","1,2,2",0.6507936507936508,0.5202661770886656,0.7666294186329925,63,41,0.5757575757575758,0.4478940377087594,0.6965980669616616,66,38,10,14,10,10,31,24,12,18
"wisconsin_exoplanets-deepseek,wisconsin_exoplanets-openai,wisconsin_exoplanets-openai10o1","1,6,5",0.6507936507936508,0.5202661770886656,0.7666294186329925,63,41,0.6363636363636364,0.5087394315103153,0.7513222169426668,66,42,15,23,15,15,26,19,7,9
"wisconsin_exoplanets-llamaphi,wisconsin_exoplanets-openai,wisconsin_exoplanets-openailong","1,6,4",0.64,0.4919313522856012,0.7708429331794127,50,32,0.6491228070175439,0.5113133824931495,0.7708544028317619,57,37,13,24,18,15,19,13,0,5
"wisconsin_exoplanets-llamaphi,wisconsin_exoplanets-openai,wisconsin_exoplanets-openai45","1,6,4",0.64,0.4919313522856012,0.7708429331794127,50,32,0.631578947368421,0.4934470331353673,0.7555359944741882,57,36,13,24,18,16,19,12,0,5
"wisconsin_exoplanets-llamaphi,wisconsin_exoplanets-openai,wisconsin_exoplanets-openai10o1","1,6,5",0.64,0.4919313522856012,0.7708429331794127,50,32,0.6140350877192983,0.4757484152435112,0.7400453190018772,57,35,13,23,18,16,19,12,0,6
"wisconsin_exoplanets-anthropic3710,wisconsin_exoplanets-llamaphi,wisconsin_exoplanets-phi","5,1,1",0.6349206349206349,0.5040487779950485,0.7526567353267375,63,40,0.6515151515151515,0.5242397683271001,0.7647080305896783,66,43,19,29,20,20,21,14,3,3
"wisconsin_exoplanets-anthropic,wisconsin_exoplanets-openai10,wisconsin_exoplanets-qwq","2,5,1",0.6349206349206349,0.5040487779950485,0.7526567353267375,63,40,0.6515151515151515,0.5242397683271001,0.7647080305896783,66,43,19,26,20,17,21,17,3,6
"wisconsin_exoplanets-deepseek,wisconsin_exoplanets-llamaphi,wisconsin_exoplanets-openai4510","1,1,2",0.6349206349206349,0.5040487779950485,0.7526567353267375,63,40,0.696969696969697,0.5714834854226349,0.8041003533935258,66,46,14,26,15,14,26,20,8,6
"wisconsin_exoplanets-deepseek,wisconsin_exoplanets-openai10o1,wisconsin_exoplanets-openai4510","1,5,2",0.6349206349206349,0.5040487779950485,0.7526567353267375,63,40,0.7424242424242424,0.6199387593265298,0.8422336207426879,66,49,14,26,15,11,26,23,8,6
"wisconsin_exoplanets-gemma,wisconsin_exoplanets-openai4510,wisconsin_exoplanets-qwq","1,2,1",0.6349206349206349,0.5040487779950485,0.7526567353267375,63,40,0.5606060606060606,0.43296119670295957,0.6826341362307495,66,37,9,9,10,6,31,28,13,23
"wisconsin_exoplanets-gemma,wisconsin_exoplanets-openai45,wisconsin_exoplanets-openai4510","1,4,2",0.6349206349206349,0.5040487779950485,0.7526567353267375,63,40,0.5757575757575758,0.4478940377087594,0.6965980669616616,66,38,17,16,18,12,23,22,5,16
"wisconsin_exoplanets-deepseek,wisconsin_exoplanets-geminipro10,wisconsin_exoplanets-openai10o1","1,3,5",0.6349206349206349,0.5040487779950485,0.7526567353267375,63,40,0.7121212121212122,0.5874932401392494,0.816959774581892,66,47,15,23,16,10,25,24,7,9
"wisconsin_exoplanets-falcon10,wisconsin_exoplanets-openai10o1,wisconsin_exoplanets-openaio1","1,5,2",0.6349206349206349,0.5040487779950485,0.7526567353267375,63,40,0.6363636363636364,0.5087394315103153,0.7513222169426668,66,42,20,25,21,17,20,17,2,7
"wisconsin_exoplanets-anthropic37,wisconsin_exoplanets-falcon,wisconsin_exoplanets-openai","2,1,6",0.6349206349206349,0.5040487779950485,0.7526567353267375,63,40,0.6363636363636364,0.5087394315103153,0.7513222169426668,66,42,21,28,22,20,19,14,1,4
"wisconsin_exoplanets-anthropic,wisconsin_exoplanets-llama,wisconsin_exoplanets-openai10o1","2,2,5",0.6349206349206349,0.5040487779950485,0.7526567353267375,63,40,0.6666666666666666,0.5398613431497497,0.7779692372780057,66,44,20,28,21,18,20,16,2,4
"wisconsin_exoplanets-gemma,wisconsin_exoplanets-openai10o1,wisconsin_exoplanets-openai4510","1,5,2",0.6349206349206349,0.5040487779950485,0.7526567353267375,63,40,0.5757575757575758,0.4478940377087594,0.6965980669616616,66,38,15,17,16,13,25,21,7,15
"wisconsin_exoplanets-anthropic,wisconsin_exoplanets-deepseek,wisconsin_exoplanets-qwq","2,1,1",0.6349206349206349,0.5040487779950485,0.7526567353267375,63,40,0.7121212121212122,0.5874932401392494,0.816959774581892,66,47,13,21,14,8,27,26,9,11
"wisconsin_exoplanets-llama,wisconsin_exoplanets-openai,wisconsin_exoplanets-openai10o1","2,6,5",0.6349206349206349,0.5040487779950485,0.7526567353267375,63,40,0.5303030303030303,0.403420053441725,0.654378697236779,66,35,15,20,16,19,25,15,7,12
"wisconsin_exoplanets-anthropic10,wisconsin_exoplanets-anthropic37,wisconsin_exoplanets-llamaphi","1,2,1",0.6349206349206349,0.5040487779950485,0.7526567353267375,63,40,0.6060606060606061,0.47809031269657515,0.7241907640463761,66,40,21,30,22,24,19,10,1,2
"wisconsin_exoplanets-anthropic37,wisconsin_exoplanets-falcon,wisconsin_exoplanets-phi","2,1,1",0.6349206349206349,0.5040487779950485,0.7526567353267375,63,40,0.6363636363636364,0.5087394315103153,0.7513222169426668,66,42,15,20,16,12,25,22,7,12
"wisconsin_exoplanets-llama,wisconsin_exoplanets-openai10,wisconsin_exoplanets-openai45","2,5,4",0.6349206349206349,0.5040487779950485,0.7526567353267375,63,40,0.5909090909090909,0.46293656355858825,0.7104508976039902,66,39,14,21,15,16,26,18,8,11
"wisconsin_exoplanets-anthropic3710,wisconsin_exoplanets-falcon,wisconsin_exoplanets-phi","5,1,1",0.6349206349206349,0.5040487779950485,0.7526567353267375,63,40,0.6363636363636364,0.5087394315103153,0.7513222169426668,66,42,15,18,16,10,25,24,7,14
"wisconsin_exoplanets-gemini,wisconsin_exoplanets-llama,wisconsin_exoplanets-openai45","7,2,4",0.6349206349206349,0.5040487779950485,0.7526567353267375,63,40,0.6212121212121212,0.4933571772023376,0.7378154230046878,66,41,19,28,20,21,21,13,3,4
"wisconsin_exoplanets-gemini,wisconsin_exoplanets-llama,wisconsin_exoplanets-openai10o1","7,2,5",0.6349206349206349,0.5040487779950485,0.7526567353267375,63,40,0.6363636363636364,0.5087394315103153,0.7513222169426668,66,42,19,26,20,18,21,16,3,6
"wisconsin_exoplanets-gemini,wisconsin_exoplanets-llama,wisconsin_exoplanets-openai10","7,2,5",0.6349206349206349,0.5040487779950485,0.7526567353267375,63,40,0.6060606060606061,0.47809031269657515,0.7241907640463761,66,40,19,28,20,22,21,12,3,4
"wisconsin_exoplanets-anthropic10,wisconsin_exoplanets-gemini10,wisconsin_exoplanets-gemma","1,2,1",0.6349206349206349,0.5040487779950485,0.7526567353267375,63,40,0.5303030303030303,0.403420053441725,0.654378697236779,66,35,7,11,8,10,33,24,15,21
"wisconsin_exoplanets-deepseek,wisconsin_exoplanets-openai,wisconsin_exoplanets-openai10","1,6,5",0.6349206349206349,0.5040487779950485,0.7526567353267375,63,40,0.6515151515151515,0.5242397683271001,0.7647080305896783,66,43,15,24,16,15,25,19,7,8
"wisconsin_exoplanets-llama,wisconsin_exoplanets-openai45,wisconsin_exoplanets-openailong","2,4,4",0.6349206349206349,0.5040487779950485,0.7526567353267375,63,40,0.5909090909090909,0.46293656355858825,0.7104508976039902,66,39,14,21,15,16,26,18,8,11
"wisconsin_exoplanets-deepseek,wisconsin_exoplanets-openai10,wisconsin_exoplanets-openai4510","1,5,2",0.6349206349206349,0.5040487779950485,0.7526567353267375,63,40,0.7272727272727273,0.6036427957562946,0.8296733838204806,66,48,14,27,15,13,26,21,8,5
"wisconsin_exoplanets-deepseek,wisconsin_exoplanets-openai10,wisconsin_exoplanets-openai45","1,5,4",0.6349206349206349,0.5040487779950485,0.7526567353267375,63,40,0.6666666666666666,0.5398613431497497,0.7779692372780057,66,44,13,22,14,12,27,22,9,10
"wisconsin_exoplanets-anthropic,wisconsin_exoplanets-falcon10,wisconsin_exoplanets-openai10","2,1,5",0.6349206349206349,0.5040487779950485,0.7526567353267375,63,40,0.7121212121212122,0.5874932401392494,0.816959774581892,66,47,20,30,21,17,20,17,2,2
"wisconsin_exoplanets-falcon10,wisconsin_exoplanets-llamaphi,wisconsin_exoplanets-openai4510","1,1,2",0.6349206349206349,0.5040487779950485,0.7526567353267375,63,40,0.6363636363636364,0.5087394315103153,0.7513222169426668,66,42,16,25,17,17,24,17,6,7
"wisconsin_exoplanets-deepseek,wisconsin_exoplanets-openai,wisconsin_exoplanets-openailong","1,6,4",0.6349206349206349,0.5040487779950485,0.7526567353267375,63,40,0.6515151515151515,0.5242397683271001,0.7647080305896783,66,43,15,24,16,15,25,19,7,8
"wisconsin_exoplanets-gemini,wisconsin_exoplanets-llama,wisconsin_exoplanets-openailong","7,2,4",0.6349206349206349,0.5040487779950485,0.7526567353267375,63,40,0.6060606060606061,0.47809031269657515,0.7241907640463761,66,40,19,28,20,22,21,12,3,4
"wisconsin_exoplanets-geminipro,wisconsin_exoplanets-gemma,wisconsin_exoplanets-llamaphi","2,1,1",0.6349206349206349,0.5040487779950485,0.7526567353267375,63,40,0.45454545454545453,0.3314393816209253,0.5818631668533873,66,30,14,11,15,15,26,19,8,21
"wisconsin_exoplanets-geminipro,wisconsin_exoplanets-llama,wisconsin_exoplanets-openailong","2,2,4",0.6349206349206349,0.5040487779950485,0.7526567353267375,63,40,0.5909090909090909,0.46293656355858825,0.7104508976039902,66,39,14,22,15,17,26,17,8,10
"wisconsin_exoplanets-deepseek,wisconsin_exoplanets-falcon,wisconsin_exoplanets-openai4510","1,1,2",0.6349206349206349,0.5040487779950485,0.7526567353267375,63,40,0.6818181818181818,0.5556078292305275,0.7911016327585585,66,45,10,15,11,4,30,30,12,17
"wisconsin_exoplanets-anthropic10,wisconsin_exoplanets-falcon10,wisconsin_exoplanets-gemini","1,1,7",0.6349206349206349,0.5040487779950485,0.7526567353267375,63,40,0.5151515151515151,0.3888102652777774,0.6400892442500232,66,34,15,16,16,16,25,18,7,16
"wisconsin_exoplanets-anthropic10,wisconsin_exoplanets-falcon10,wisconsin_exoplanets-gemma","1,1,1",0.6349206349206349,0.5040487779950485,0.7526567353267375,63,40,0.48484848484848486,0.3599107557499768,0.6111897347222226,66,32,14,17,15,19,26,15,8,15
"wisconsin_exoplanets-geminipro10,wisconsin_exoplanets-llama,wisconsin_exoplanets-qwq","3,2,1",0.6349206349206349,0.5040487779950485,0.7526567353267375,63,40,0.5303030303030303,0.403420053441725,0.654378697236779,66,35,9,11,10,10,31,24,13,21
"wisconsin_exoplanets-geminipro10,wisconsin_exoplanets-gemma,wisconsin_exoplanets-openai","3,1,6",0.6349206349206349,0.5040487779950485,0.7526567353267375,63,40,0.5151515151515151,0.3888102652777774,0.6400892442500232,66,34,15,14,16,14,25,20,7,18
"wisconsin_exoplanets-deepseek,wisconsin_exoplanets-gemini,wisconsin_exoplanets-openai10","1,7,5",0.6349206349206349,0.5040487779950485,0.7526567353267375,63,40,0.6363636363636364,0.5087394315103153,0.7513222169426668,66,42,20,25,21,17,20,17,2,7
"wisconsin_exoplanets-anthropic,wisconsin_exoplanets-anthropic10,wisconsin_exoplanets-qwq","2,1,1",0.6349206349206349,0.5040487779950485,0.7526567353267375,63,40,0.6060606060606061,0.47809031269657515,0.7241907640463761,66,40,14,19,15,13,26,21,8,13
"wisconsin_exoplanets-geminipro10,wisconsin_exoplanets-llama,wisconsin_exoplanets-openai45","3,2,4",0.6349206349206349,0.5040487779950485,0.7526567353267375,63,40,0.6212121212121212,0.4933571772023376,0.7378154230046878,66,41,16,23,17,16,24,18,6,9
"wisconsin_exoplanets-gemini10,wisconsin_exoplanets-gemma,wisconsin_exoplanets-openai10o1","2,1,5",0.6349206349206349,0.5040487779950485,0.7526567353267375,63,40,0.5454545454545454,0.4181368331466126,0.6685606183790747,66,36,14,15,15,13,26,21,8,17
"wisconsin_exoplanets-geminipro,wisconsin_exoplanets-llama,wisconsin_exoplanets-qwq","2,2,1",0.6349206349206349,0.5040487779950485,0.7526567353267375,63,40,0.5151515151515151,0.3888102652777774,0.6400892442500232,66,34,8,10,9,10,32,24,14,22
"wisconsin_exoplanets-falcon,wisconsin_exoplanets-falcon10,wisconsin_exoplanets-openai4510","1,1,2",0.6349206349206349,0.5040487779950485,0.7526567353267375,63,40,0.5606060606060606,0.43296119670295957,0.6826341362307495,66,37,11,12,12,9,29,25,11,20
"wisconsin_exoplanets-geminipro10,wisconsin_exoplanets-llama,wisconsin_exoplanets-openai10o1","3,2,5",0.6349206349206349,0.5040487779950485,0.7526567353267375,63,40,0.5909090909090909,0.46293656355858825,0.7104508976039902,66,39,15,21,16,16,25,18,7,11
"wisconsin_exoplanets-falcon10,wisconsin_exoplanets-gemini10,wisconsin_exoplanets-llamaphi","1,2,1",0.6349206349206349,0.5040487779950485,0.7526567353267375,63,40,0.6060606060606061,0.47809031269657515,0.7241907640463761,66,40,15,22,16,16,25,18,7,10
"wisconsin_exoplanets-falcon10,wisconsin_exoplanets-gemini10,wisconsin_exoplanets-openai","1,2,6",0.6349206349206349,0.5040487779950485,0.7526567353267375,63,40,0.6060606060606061,0.47809031269657515,0.7241907640463761,66,40,15,21,16,15,25,19,7,11
"wisconsin_exoplanets-gemini10,wisconsin_exoplanets-llama,wisconsin_exoplanets-qwq","2,2,1",0.6349206349206349,0.5040487779950485,0.7526567353267375,63,40,0.5,0.37430716945155507,0.6256928305484449,66,33,8,9,9,10,32,24,14,23
"wisconsin_exoplanets-openai4510,wisconsin_exoplanets-phi,wisconsin_exoplanets-qwq","2,1,1",0.6349206349206349,0.5040487779950485,0.7526567353267375,63,40,0.5606060606060606,0.43296119670295957,0.6826341362307495,66,37,9,11,10,8,31,26,13,21
"wisconsin_exoplanets-gemini10,wisconsin_exoplanets-llama,wisconsin_exoplanets-openai10","2,2,5",0.6349206349206349,0.5040487779950485,0.7526567353267375,63,40,0.6363636363636364,0.5087394315103153,0.7513222169426668,66,42,14,24,15,16,26,18,8,8
"wisconsin_exoplanets-deepseek,wisconsin_exoplanets-falcon10,wisconsin_exoplanets-geminipro","1,1,2",0.6349206349206349,0.5040487779950485,0.7526567353267375,63,40,0.6363636363636364,0.5087394315103153,0.7513222169426668,66,42,9,15,10,7,31,27,13,17
"wisconsin_exoplanets-deepseek,wisconsin_exoplanets-falcon10,wisconsin_exoplanets-gemma","1,1,1",0.6349206349206349,0.5040487779950485,0.7526567353267375,63,40,0.5757575757575758,0.4478940377087594,0.6965980669616616,66,38,14,20,15,16,26,18,8,12
"wisconsin_exoplanets-deepseek,wisconsin_exoplanets-openaio1,wisconsin_exoplanets-qwq","1,2,1",0.6349206349206349,0.5040487779950485,0.7526567353267375,63,40,0.696969696969697,0.5714834854226349,0.8041003533935258,66,46,12,20,13,8,28,26,10,12
"wisconsin_exoplanets-geminipro,wisconsin_exoplanets-gemma,wisconsin_exoplanets-llama","2,1,2",0.6349206349206349,0.5040487779950485,0.7526567353267375,63,40,0.4696969696969697,0.345621302763221,0.5965799465582751,66,31,10,7,11,10,30,24,12,25
"wisconsin_exoplanets-deepseek,wisconsin_exoplanets-gemini,wisconsin_exoplanets-llamaphi","1,7,1",0.6349206349206349,0.5040487779950485,0.7526567353267375,63,40,0.6060606060606061,0.47809031269657515,0.7241907640463761,66,40,19,24,20,18,21,16,3,8
"wisconsin_exoplanets-geminipro,wisconsin_exoplanets-llama,wisconsin_exoplanets-openai10o1","2,2,5",0.6349206349206349,0.5040487779950485,0.7526567353267375,63,40,0.5757575757575758,0.4478940377087594,0.6965980669616616,66,38,13,20,14,16,27,18,9,12
"wisconsin_exoplanets-anthropic3710,wisconsin_exoplanets-falcon,wisconsin_exoplanets-llamaphi","5,1,1",0.6190476190476191,0.48796339720069076,0.7385486897528575,63,39,0.6363636363636364,0.5087394315103153,0.7513222169426668,66,42,20,28,22,20,19,14,2,4
"wisconsin_exoplanets-geminipro,wisconsin_exoplanets-gemma,wisconsin_exoplanets-openai10o1","2,1,5",0.6190476190476191,0.48796339720069076,0.7385486897528575,63,39,0.48484848484848486,0.3599107557499768,0.6111897347222226,66,32,14,11,16,13,25,21,8,21
"wisconsin_exoplanets-falcon,wisconsin_exoplanets-gemini10,wisconsin_exoplanets-gemma","1,2,1",0.6190476190476191,0.48796339720069076,0.7385486897528575,63,39,0.5,0.37430716945155507,0.6256928305484449,66,33,7,7,9,8,32,26,15,25
"wisconsin_exoplanets-geminipro,wisconsin_exoplanets-llama,wisconsin_exoplanets-openai10","2,2,5",0.6190476190476191,0.48796339720069076,0.7385486897528575,63,39,0.5909090909090909,0.46293656355858825,0.7104508976039902,66,39,13,22,15,17,26,17,9,10
"wisconsin_exoplanets-anthropic10,wisconsin_exoplanets-geminipro,wisconsin_exoplanets-gemma","1,2,1",0.6190476190476191,0.48796339720069076,0.7385486897528575,63,39,0.45454545454545453,0.3314393816209253,0.5818631668533873,66,30,7,6,9,10,32,24,15,26
"wisconsin_exoplanets-deepseek,wisconsin_exoplanets-openai,wisconsin_exoplanets-openai45","1,6,4",0.6190476190476191,0.48796339720069076,0.7385486897528575,63,39,0.6666666666666666,0.5398613431497497,0.7779692372780057,66,44,15,24,17,14,24,20,7,8
"wisconsin_exoplanets-anthropic3710,wisconsin_exoplanets-gemma,wisconsin_exoplanets-openai10","5,1,5",0.6190476190476191,0.48796339720069076,0.7385486897528575,63,39,0.7121212121212122,0.5874932401392494,0.816959774581892,66,47,18,31,20,18,21,16,4,1
"wisconsin_exoplanets-anthropic,wisconsin_exoplanets-openailong,wisconsin_exoplanets-phi","2,4,1",0.6190476190476191,0.48796339720069076,0.7385486897528575,63,39,0.7121212121212122,0.5874932401392494,0.816959774581892,66,47,21,28,23,15,18,19,1,4
"wisconsin_exoplanets-anthropic,wisconsin_exoplanets-openai10o1,wisconsin_exoplanets-qwq","2,5,1",0.6190476190476191,0.48796339720069076,0.7385486897528575,63,39,0.6515151515151515,0.5242397683271001,0.7647080305896783,66,43,19,25,21,16,20,18,3,7
"wisconsin_exoplanets-anthropic10,wisconsin_exoplanets-gemini,wisconsin_exoplanets-phi","1,7,1",0.6190476190476191,0.48796339720069076,0.7385486897528575,63,39,0.5303030303030303,0.403420053441725,0.654378697236779,66,35,13,16,15,15,26,19,9,16
"wisconsin_exoplanets-anthropic,wisconsin_exoplanets-openai,wisconsin_exoplanets-phi","2,6,1",0.6190476190476191,0.48796339720069076,0.7385486897528575,63,39,0.696969696969697,0.5714834854226349,0.8041003533935258,66,46,21,28,23,16,18,18,1,4
"wisconsin_exoplanets-anthropic3710,wisconsin_exoplanets-openai45,wisconsin_exoplanets-phi","5,4,1",0.6190476190476191,0.48796339720069076,0.7385486897528575,63,39,0.7121212121212122,0.5874932401392494,0.816959774581892,66,47,20,31,22,18,19,16,2,1
"wisconsin_exoplanets-deepseek,wisconsin_exoplanets-llamaphi,wisconsin_exoplanets-openai10o1","1,1,5",0.6190476190476191,0.48796339720069076,0.7385486897528575,63,39,0.5909090909090909,0.46293656355858825,0.7104508976039902,66,39,14,22,16,17,25,17,8,10
"wisconsin_exoplanets-anthropic,wisconsin_exoplanets-llama,wisconsin_exoplanets-openai10","2,2,5",0.6190476190476191,0.48796339720069076,0.7385486897528575,63,39,0.6666666666666666,0.5398613431497497,0.7779692372780057,66,44,20,29,22,19,19,15,2,3
"wisconsin_exoplanets-falcon10,wisconsin_exoplanets-openai45,wisconsin_exoplanets-openai4510","1,4,2",0.6190476190476191,0.48796339720069076,0.7385486897528575,63,39,0.6666666666666666,0.5398613431497497,0.7779692372780057,66,44,16,25,18,15,23,19,6,7
"wisconsin_exoplanets-geminipro10,wisconsin_exoplanets-gemma,wisconsin_exoplanets-llamaphi","3,1,1",0.6190476190476191,0.48796339720069076,0.7385486897528575,63,39,0.5,0.37430716945155507,0.6256928305484449,66,33,14,14,16,15,25,19,8,18
"wisconsin_exoplanets-deepseek,wisconsin_exoplanets-openai10,wisconsin_exoplanets-openailong","1,5,4",0.6190476190476191,0.48796339720069076,0.7385486897528575,63,39,0.6515151515151515,0.5242397683271001,0.7647080305896783,66,43,12,22,14,13,27,21,10,10
"wisconsin_exoplanets-geminipro10,wisconsin_exoplanets-gemma,wisconsin_exoplanets-openai10o1","3,1,5",0.6190476190476191,0.48796339720069076,0.7385486897528575,63,39,0.5303030303030303,0.403420053441725,0.654378697236779,66,35,15,14,17,13,24,21,7,18
"wisconsin_exoplanets-gemini,wisconsin_exoplanets-openai,wisconsin_exoplanets-qwq","7,6,1",0.6190476190476191,0.48796339720069076,0.7385486897528575,63,39,0.5757575757575758,0.4478940377087594,0.6965980669616616,66,38,18,21,20,17,21,17,4,11
"wisconsin_exoplanets-falcon,wisconsin_exoplanets-gemini10,wisconsin_exoplanets-llama","1,2,2",0.6190476190476191,0.48796339720069076,0.7385486897528575,63,39,0.5303030303030303,0.403420053441725,0.654378697236779,66,35,8,11,10,10,31,24,14,21
"wisconsin_exoplanets-gemma,wisconsin_exoplanets-openai,wisconsin_exoplanets-openailong","1,6,4",0.6190476190476191,0.48796339720069076,0.7385486897528575,63,39,0.4696969696969697,0.345621302763221,0.5965799465582751,66,31,15,13,17,16,24,18,7,19
"wisconsin_exoplanets-anthropic10,wisconsin_exoplanets-deepseek,wisconsin_exoplanets-geminipro10","1,1,3",0.6190476190476191,0.48796339720069076,0.7385486897528575,63,39,0.6060606060606061,0.47809031269657515,0.7241907640463761,66,40,8,13,10,7,31,27,14,19
"wisconsin_exoplanets-gemma,wisconsin_exoplanets-openai,wisconsin_exoplanets-openai10o1","1,6,5",0.6190476190476191,0.48796339720069076,0.7385486897528575,63,39,0.4393939393939394,0.31736586376925047,0.5670388032970404,66,29,14,12,16,17,25,17,8,20
"wisconsin_exoplanets-anthropic10,wisconsin_exoplanets-deepseek,wisconsin_exoplanets-llama","1,1,2",0.6190476190476191,0.48796339720069076,0.7385486897528575,63,39,0.6060606060606061,0.47809031269657515,0.7241907640463761,66,40,13,22,15,16,26,18,9,10
"wisconsin_exoplanets-deepseek,wisconsin_exoplanets-openai10o1,wisconsin_exoplanets-openailong","1,5,4",0.6190476190476191,0.48796339720069076,0.7385486897528575,63,39,0.6212121212121212,0.4933571772023376,0.7378154230046878,66,41,13,22,15,15,26,19,9,10
"wisconsin_exoplanets-llama,wisconsin_exoplanets-llamaphi,wisconsin_exoplanets-openai10o1","2,1,5",0.6190476190476191,0.48796339720069076,0.7385486897528575,63,39,0.5303030303030303,0.403420053441725,0.654378697236779,66,35,14,20,16,19,25,15,8,12
"wisconsin_exoplanets-anthropic10,wisconsin_exoplanets-openaio1,wisconsin_exoplanets-phi","1,2,1",0.6190476190476191,0.48796339720069076,0.7385486897528575,63,39,0.5606060606060606,0.43296119670295957,0.6826341362307495,66,37,13,19,15,16,26,18,9,13
"wisconsin_exoplanets-geminipro10,wisconsin_exoplanets-phi,wisconsin_exoplanets-qwq","3,1,1",0.6190476190476191,0.48796339720069076,0.7385486897528575,63,39,0.5606060606060606,0.43296119670295957,0.6826341362307495,66,37,8,10,10,7,31,27,14,22
"wisconsin_exoplanets-anthropic37,wisconsin_exoplanets-falcon,wisconsin_exoplanets-llamaphi","2,1,1",0.6190476190476191,0.48796339720069076,0.7385486897528575,63,39,0.6212121212121212,0.4933571772023376,0.7378154230046878,66,41,20,28,22,21,19,13,2,4
"wisconsin_exoplanets-llama,wisconsin_exoplanets-openai,wisconsin_exoplanets-openailong","2,6,4",0.6190476190476191,0.48796339720069076,0.7385486897528575,63,39,0.5606060606060606,0.43296119670295957,0.6826341362307495,66,37,15,21,17,18,24,16,7,11
"wisconsin_exoplanets-anthropic10,wisconsin_exoplanets-anthropic37,wisconsin_exoplanets-openai10o1","1,2,5",0.6190476190476191,0.48796339720069076,0.7385486897528575,63,39,0.6818181818181818,0.5556078292305275,0.7911016327585585,66,45,22,32,24,21,17,13,0,0
"wisconsin_exoplanets-anthropic37,wisconsin_exoplanets-falcon,wisconsin_exoplanets-openai45","2,1,4",0.6190476190476191,0.48796339720069076,0.7385486897528575,63,39,0.6212121212121212,0.4933571772023376,0.7378154230046878,66,41,21,28,23,21,18,13,1,4
"wisconsin_exoplanets-anthropic37,wisconsin_exoplanets-falcon,wisconsin_exoplanets-openailong","2,1,4",0.6190476190476191,0.48796339720069076,0.7385486897528575,63,39,0.6060606060606061,0.47809031269657515,0.7241907640463761,66,40,21,28,23,22,18,12,1,4
"wisconsin_exoplanets-falcon,wisconsin_exoplanets-gemini,wisconsin_exoplanets-llama","1,7,2",0.6190476190476191,0.48796339720069076,0.7385486897528575,63,39,0.6515151515151515,0.5242397683271001,0.7647080305896783,66,43,13,21,15,12,26,22,9,11
"wisconsin_exoplanets-gemini,wisconsin_exoplanets-llamaphi,wisconsin_exoplanets-qwq","7,1,1",0.6190476190476191,0.48796339720069076,0.7385486897528575,63,39,0.5454545454545454,0.4181368331466126,0.6685606183790747,66,36,18,21,20,19,21,15,4,11
"wisconsin_exoplanets-deepseek,wisconsin_exoplanets-gemini,wisconsin_exoplanets-qwq","1,7,1",0.6190476190476191,0.48796339720069076,0.7385486897528575,63,39,0.5909090909090909,0.46293656355858825,0.7104508976039902,66,39,11,18,13,13,28,21,11,14
"wisconsin_exoplanets-llama,wisconsin_exoplanets-openai10,wisconsin_exoplanets-openailong","2,5,4",0.6190476190476191,0.48796339720069076,0.7385486897528575,63,39,0.5909090909090909,0.46293656355858825,0.7104508976039902,66,39,13,21,15,16,26,18,9,11
"wisconsin_exoplanets-anthropic10,wisconsin_exoplanets-anthropic3710,wisconsin_exoplanets-openai","1,5,6",0.6190476190476191,0.48796339720069076,0.7385486897528575,63,39,0.6515151515151515,0.5242397683271001,0.7647080305896783,66,43,18,30,20,21,21,13,4,2
"wisconsin_exoplanets-llama,wisconsin_exoplanets-openai10o1,wisconsin_exoplanets-openailong","2,5,4",0.6190476190476191,0.48796339720069076,0.7385486897528575,63,39,0.5606060606060606,0.43296119670295957,0.6826341362307495,66,37,14,21,16,18,25,16,8,11
"wisconsin_exoplanets-geminipro10,wisconsin_exoplanets-llama,wisconsin_exoplanets-openailong","3,2,4",0.6190476190476191,0.48796339720069076,0.7385486897528575,63,39,0.6060606060606061,0.47809031269657515,0.7241907640463761,66,40,15,23,17,17,24,17,7,9
"wisconsin_exoplanets-falcon,wisconsin_exoplanets-gemini,wisconsin_exoplanets-gemma","1,7,1",0.6190476190476191,0.48796339720069076,0.7385486897528575,63,39,0.4696969696969697,0.345621302763221,0.5965799465582751,66,31,12,10,14,13,27,21,10,22
"wisconsin_exoplanets-gemma,wisconsin_exoplanets-openai4510,wisconsin_exoplanets-openailong","1,2,4",0.6190476190476191,0.48796339720069076,0.7385486897528575,63,39,0.5606060606060606,0.43296119670295957,0.6826341362307495,66,37,16,16,18,13,23,21,6,16
"wisconsin_exoplanets-gemini,wisconsin_exoplanets-gemma,wisconsin_exoplanets-qwq","7,1,1",0.6190476190476191,0.48796339720069076,0.7385486897528575,63,39,0.5151515151515151,0.3888102652777774,0.6400892442500232,66,34,12,12,14,12,27,22,10,20
"wisconsin_exoplanets-anthropic,wisconsin_exoplanets-falcon10,wisconsin_exoplanets-openai10o1","2,1,5",0.6190476190476191,0.48796339720069076,0.7385486897528575,63,39,0.7424242424242424,0.6199387593265298,0.8422336207426879,66,49,19,29,21,14,20,20,3,3
"wisconsin_exoplanets-falcon10,wisconsin_exoplanets-gemini10,wisconsin_exoplanets-openai45","1,2,4",0.6190476190476191,0.48796339720069076,0.7385486897528575,63,39,0.6212121212121212,0.4933571772023376,0.7378154230046878,66,41,15,21,17,14,24,20,7,11
"wisconsin_exoplanets-anthropic,wisconsin_exoplanets-falcon,wisconsin_exoplanets-falcon10","2,1,1",0.6190476190476191,0.48796339720069076,0.7385486897528575,63,39,0.6666666666666666,0.5398613431497497,0.7779692372780057,66,44,14,22,16,12,25,22,8,10
"wisconsin_exoplanets-deepseek,wisconsin_exoplanets-geminipro10,wisconsin_exoplanets-qwq","1,3,1",0.6190476190476191,0.48796339720069076,0.7385486897528575,63,39,0.5757575757575758,0.4478940377087594,0.6965980669616616,66,38,8,11,10,7,31,27,14,21
"wisconsin_exoplanets-deepseek,wisconsin_exoplanets-gemini10,wisconsin_exoplanets-qwq","1,2,1",0.6190476190476191,0.48796339720069076,0.7385486897528575,63,39,0.6363636363636364,0.5087394315103153,0.7513222169426668,66,42,7,14,9,6,32,28,15,18
"wisconsin_exoplanets-anthropic,wisconsin_exoplanets-deepseek,wisconsin_exoplanets-falcon","2,1,1",0.6190476190476191,0.48796339720069076,0.7385486897528575,63,39,0.7727272727272727,0.6530018980228203,0.8668572164845951,66,51,13,21,15,4,26,30,9,11
"wisconsin_exoplanets-anthropic,wisconsin_exoplanets-falcon,wisconsin_exoplanets-llama","2,1,2",0.6190476190476191,0.48796339720069076,0.7385486897528575,63,39,0.6515151515151515,0.5242397683271001,0.7647080305896783,66,43,15,22,17,13,24,21,7,10
"wisconsin_exoplanets-deepseek,wisconsin_exoplanets-geminipro,wisconsin_exoplanets-openai10o1","1,2,5",0.6190476190476191,0.48796339720069076,0.7385486897528575,63,39,0.7121212121212122,0.5874932401392494,0.816959774581892,66,47,13,23,15,10,26,24,9,9
"wisconsin_exoplanets-deepseek,wisconsin_exoplanets-geminipro,wisconsin_exoplanets-openai10","1,2,5",0.6190476190476191,0.48796339720069076,0.7385486897528575,63,39,0.6818181818181818,0.5556078292305275,0.7911016327585585,66,45,13,23,15,12,26,22,9,9
"wisconsin_exoplanets-anthropic3710,wisconsin_exoplanets-openailong,wisconsin_exoplanets-phi","5,4,1",0.6190476190476191,0.48796339720069076,0.7385486897528575,63,39,0.7121212121212122,0.5874932401392494,0.816959774581892,66,47,19,31,21,18,20,16,3,1
"wisconsin_exoplanets-falcon10,wisconsin_exoplanets-geminipro,wisconsin_exoplanets-openai","1,2,6",0.6190476190476191,0.48796339720069076,0.7385486897528575,63,39,0.5909090909090909,0.46293656355858825,0.7104508976039902,66,39,14,21,16,16,25,18,8,11
"wisconsin_exoplanets-deepseek,wisconsin_exoplanets-geminipro10,wisconsin_exoplanets-openai10","1,3,5",0.6190476190476191,0.48796339720069076,0.7385486897528575,63,39,0.6818181818181818,0.5556078292305275,0.7911016327585585,66,45,14,23,16,12,25,22,8,9
"wisconsin_exoplanets-falcon10,wisconsin_exoplanets-llamaphi,wisconsin_exoplanets-openai","1,1,6",0.6190476190476191,0.48796339720069076,0.7385486897528575,63,39,0.5909090909090909,0.46293656355858825,0.7104508976039902,66,39,14,21,16,16,25,18,8,11
"wisconsin_exoplanets-deepseek,wisconsin_exoplanets-openai10,wisconsin_exoplanets-openai10o1","1,5,5",0.6031746031746031,0.47200694631116646,0.724308882224939,63,38,0.6212121212121212,0.4933571772023376,0.7378154230046878,66,41,12,22,15,15,26,19,10,10
"wisconsin_exoplanets-gemini,wisconsin_exoplanets-gemma,wisconsin_exoplanets-openai45","7,1,4",0.6031746031746031,0.47200694631116646,0.724308882224939,63,38,0.5909090909090909,0.46293656355858825,0.7104508976039902,66,39,19,22,22,17,19,17,3,10
"wisconsin_exoplanets-gemini,wisconsin_exoplanets-gemma,wisconsin_exoplanets-openailong","7,1,4",0.6031746031746031,0.47200694631116646,0.724308882224939,63,38,0.5757575757575758,0.4478940377087594,0.6965980669616616,66,38,19,22,22,18,19,16,3,10
"wisconsin_exoplanets-gemini,wisconsin_exoplanets-gemma,wisconsin_exoplanets-openai10o1","7,1,5",0.6031746031746031,0.47200694631116646,0.724308882224939,63,38,0.6212121212121212,0.4933571772023376,0.7378154230046878,66,41,18,22,21,15,20,19,4,10
"wisconsin_exoplanets-falcon10,wisconsin_exoplanets-geminipro,wisconsin_exoplanets-llamaphi","1,2,1",0.6031746031746031,0.47200694631116646,0.724308882224939,63,38,0.5757575757575758,0.4478940377087594,0.6965980669616616,66,38,13,21,16,17,25,17,9,11
"wisconsin_exoplanets-anthropic10,wisconsin_exoplanets-anthropic37,wisconsin_exoplanets-openailong","1,2,4",0.6031746031746031,0.47200694631116646,0.724308882224939,63,38,0.6515151515151515,0.5242397683271001,0.7647080305896783,66,43,21,31,24,22,17,12,1,1
"wisconsin_exoplanets-anthropic10,wisconsin_exoplanets-anthropic37,wisconsin_exoplanets-openai45","1,2,4",0.6031746031746031,0.47200694631116646,0.724308882224939,63,38,0.6515151515151515,0.5242397683271001,0.7647080305896783,66,43,22,31,25,22,16,12,0,1
"wisconsin_exoplanets-anthropic,wisconsin_exoplanets-anthropic10,wisconsin_exoplanets-openai","2,1,6",0.6031746031746031,0.47200694631116646,0.724308882224939,63,38,0.6212121212121212,0.4933571772023376,0.7378154230046878,66,41,20,28,23,21,18,13,2,4
"wisconsin_exoplanets-llama,wisconsin_exoplanets-openai,wisconsin_exoplanets-openai45","2,6,4",0.6031746031746031,0.47200694631116646,0.724308882224939,63,38,0.5606060606060606,0.43296119670295957,0.6826341362307495,66,37,15,21,18,18,23,16,7,11
"wisconsin_exoplanets-deepseek,wisconsin_exoplanets-geminipro,wisconsin_exoplanets-qwq","1,2,1",0.6031746031746031,0.47200694631116646,0.724308882224939,63,38,0.5757575757575758,0.4478940377087594,0.6965980669616616,66,38,7,11,10,7,31,27,15,21
"wisconsin_exoplanets-anthropic10,wisconsin_exoplanets-anthropic3710,wisconsin_exoplanets-falcon","1,5,1",0.6031746031746031,0.47200694631116646,0.724308882224939,63,38,0.6363636363636364,0.5087394315103153,0.7513222169426668,66,42,11,21,14,13,27,21,11,11
"wisconsin_exoplanets-deepseek,wisconsin_exoplanets-gemma,wisconsin_exoplanets-llama","1,1,2",0.6031746031746031,0.47200694631116646,0.724308882224939,63,38,0.5454545454545454,0.4181368331466126,0.6685606183790747,66,36,13,19,16,17,25,17,9,13
"wisconsin_exoplanets-gemma,wisconsin_exoplanets-openai10,wisconsin_exoplanets-openai4510","1,5,2",0.6031746031746031,0.47200694631116646,0.724308882224939,63,38,0.5757575757575758,0.4478940377087594,0.6965980669616616,66,38,15,17,18,13,23,21,7,15
"wisconsin_exoplanets-anthropic3710,wisconsin_exoplanets-falcon,wisconsin_exoplanets-openai45","5,1,4",0.6031746031746031,0.47200694631116646,0.724308882224939,63,38,0.6515151515151515,0.5242397683271001,0.7647080305896783,66,43,21,28,24,19,17,15,1,4
"wisconsin_exoplanets-falcon10,wisconsin_exoplanets-geminipro10,wisconsin_exoplanets-openai","1,3,6",0.6031746031746031,0.47200694631116646,0.724308882224939,63,38,0.6060606060606061,0.47809031269657515,0.7241907640463761,66,40,15,22,18,16,23,18,7,10
"wisconsin_exoplanets-llama,wisconsin_exoplanets-openai,wisconsin_exoplanets-openai10","2,6,5",0.6031746031746031,0.47200694631116646,0.724308882224939,63,38,0.5757575757575758,0.4478940377087594,0.6965980669616616,66,38,15,22,18,18,23,16,7,10
"wisconsin_exoplanets-anthropic37,wisconsin_exoplanets-falcon,wisconsin_exoplanets-openai10","2,1,5",0.6031746031746031,0.47200694631116646,0.724308882224939,63,38,0.6212121212121212,0.4933571772023376,0.7378154230046878,66,41,20,29,23,22,18,12,2,3
"wisconsin_exoplanets-llama,wisconsin_exoplanets-llamaphi,wisconsin_exoplanets-openailong","2,1,4",0.6031746031746031,0.47200694631116646,0.724308882224939,63,38,0.5606060606060606,0.43296119670295957,0.6826341362307495,66,37,14,21,17,18,24,16,8,11
"wisconsin_exoplanets-deepseek,wisconsin_exoplanets-falcon,wisconsin_exoplanets-gemini10","1,1,2",0.6031746031746031,0.47200694631116646,0.724308882224939,63,38,0.6666666666666666,0.5398613431497497,0.7779692372780057,66,44,7,13,10,3,31,31,15,19
"wisconsin_exoplanets-anthropic37,wisconsin_exoplanets-falcon,wisconsin_exoplanets-qwq","2,1,1",0.6031746031746031,0.47200694631116646,0.724308882224939,63,38,0.6060606060606061,0.47809031269657515,0.7241907640463761,66,40,12,18,15,12,26,22,10,14
"wisconsin_exoplanets-falcon10,wisconsin_exoplanets-geminipro10,wisconsin_exoplanets-qwq","1,3,1",0.6031746031746031,0.47200694631116646,0.724308882224939,63,38,0.5757575757575758,0.4478940377087594,0.6965980669616616,66,38,10,12,13,8,28,26,12,20
"wisconsin_exoplanets-falcon,wisconsin_exoplanets-openaio1,wisconsin_exoplanets-qwq","1,2,1",0.6031746031746031,0.47200694631116646,0.724308882224939,63,38,0.5303030303030303,0.403420053441725,0.654378697236779,66,35,11,12,14,11,27,23,11,20
"wisconsin_exoplanets-deepseek,wisconsin_exoplanets-openai10o1,wisconsin_exoplanets-openai45","1,5,4",0.6031746031746031,0.47200694631116646,0.724308882224939,63,38,0.6363636363636364,0.5087394315103153,0.7513222169426668,66,42,13,22,16,14,25,20,9,10
"wisconsin_exoplanets-geminipro,wisconsin_exoplanets-gemma,wisconsin_exoplanets-openai45","2,1,4",0.6031746031746031,0.47200694631116646,0.724308882224939,63,38,0.5,0.37430716945155507,0.6256928305484449,66,33,15,11,18,12,23,22,7,21
"wisconsin_exoplanets-llama,wisconsin_exoplanets-openai10o1,wisconsin_exoplanets-openai45","2,5,4",0.6031746031746031,0.47200694631116646,0.724308882224939,63,38,0.5606060606060606,0.43296119670295957,0.6826341362307495,66,37,14,21,17,18,24,16,8,11
"wisconsin_exoplanets-anthropic10,wisconsin_exoplanets-anthropic3710,wisconsin_exoplanets-llamaphi","1,5,1",0.6031746031746031,0.47200694631116646,0.724308882224939,63,38,0.6060606060606061,0.47809031269657515,0.7241907640463761,66,40,17,29,20,23,21,11,5,3
"wisconsin_exoplanets-anthropic,wisconsin_exoplanets-falcon,wisconsin_exoplanets-phi","2,1,1",0.6031746031746031,0.47200694631116646,0.724308882224939,63,38,0.696969696969697,0.5714834854226349,0.8041003533935258,66,46,14,19,17,7,24,27,8,13
"wisconsin_exoplanets-gemma,wisconsin_exoplanets-openai45,wisconsin_exoplanets-openailong","1,4,4",0.6031746031746031,0.47200694631116646,0.724308882224939,63,38,0.4696969696969697,0.345621302763221,0.5965799465582751,66,31,14,10,17,13,24,21,8,22
"wisconsin_exoplanets-falcon10,wisconsin_exoplanets-geminipro,wisconsin_exoplanets-openai45","1,2,4",0.6031746031746031,0.47200694631116646,0.724308882224939,63,38,0.6060606060606061,0.47809031269657515,0.7241907640463761,66,40,14,21,17,15,24,19,8,11
"wisconsin_exoplanets-falcon,wisconsin_exoplanets-geminipro10,wisconsin_exoplanets-llama","1,3,2",0.6031746031746031,0.47200694631116646,0.724308882224939,63,38,0.5454545454545454,0.4181368331466126,0.6685606183790747,66,36,9,12,12,10,29,24,13,20
"wisconsin_exoplanets-anthropic10,wisconsin_exoplanets-deepseek,wisconsin_exoplanets-geminipro","1,1,2",0.6031746031746031,0.47200694631116646,0.724308882224939,63,38,0.5909090909090909,0.46293656355858825,0.7104508976039902,66,39,7,12,10,7,31,27,15,20
"wisconsin_exoplanets-gemini10,wisconsin_exoplanets-gemma,wisconsin_exoplanets-openai45","2,1,4",0.6031746031746031,0.47200694631116646,0.724308882224939,63,38,0.5606060606060606,0.43296119670295957,0.6826341362307495,66,37,14,15,17,12,24,22,8,17
"wisconsin_exoplanets-falcon,wisconsin_exoplanets-openaio1,wisconsin_exoplanets-phi","1,2,1",0.6031746031746031,0.47200694631116646,0.724308882224939,63,38,0.5606060606060606,0.43296119670295957,0.6826341362307495,66,37,15,13,18,10,23,24,7,19
"wisconsin_exoplanets-gemma,wisconsin_exoplanets-openai,wisconsin_exoplanets-openai45","1,6,4",0.6031746031746031,0.47200694631116646,0.724308882224939,63,38,0.4696969696969697,0.345621302763221,0.5965799465582751,66,31,15,13,18,16,23,18,7,19
"wisconsin_exoplanets-gemma,wisconsin_exoplanets-llamaphi,wisconsin_exoplanets-openai10o1","1,1,5",0.6031746031746031,0.47200694631116646,0.724308882224939,63,38,0.42424242424242425,0.30340193303833835,0.5521059622912405,66,28,14,12,17,18,24,16,8,20
"wisconsin_exoplanets-falcon10,wisconsin_exoplanets-openai4510,wisconsin_exoplanets-openailong","1,2,4",0.6031746031746031,0.47200694631116646,0.724308882224939,63,38,0.6515151515151515,0.5242397683271001,0.7647080305896783,66,43,15,25,18,16,23,18,7,7
"wisconsin_exoplanets-anthropic10,wisconsin_exoplanets-gemini10,wisconsin_exoplanets-phi","1,2,1",0.6031746031746031,0.47200694631116646,0.724308882224939,63,38,0.5151515151515151,0.3888102652777774,0.6400892442500232,66,34,8,11,11,11,30,23,14,21
"wisconsin_exoplanets-geminipro10,wisconsin_exoplanets-llama,wisconsin_exoplanets-openai10","3,2,5",0.6031746031746031,0.47200694631116646,0.724308882224939,63,38,0.6060606060606061,0.47809031269657515,0.7241907640463761,66,40,14,23,17,17,24,17,8,9
"wisconsin_exoplanets-falcon10,wisconsin_exoplanets-gemini,wisconsin_exoplanets-qwq","1,7,1",0.6031746031746031,0.47200694631116646,0.724308882224939,63,38,0.6212121212121212,0.4933571772023376,0.7378154230046878,66,41,13,18,16,11,25,23,9,14
"wisconsin_exoplanets-falcon10,wisconsin_exoplanets-gemini,wisconsin_exoplanets-llamaphi","1,7,1",0.6031746031746031,0.47200694631116646,0.724308882224939,63,38,0.5757575757575758,0.4478940377087594,0.6965980669616616,66,38,19,25,22,21,19,13,3,7
"wisconsin_exoplanets-deepseek,wisconsin_exoplanets-llamaphi,wisconsin_exoplanets-openailong","1,1,4",0.6031746031746031,0.47200694631116646,0.724308882224939,63,38,0.6060606060606061,0.47809031269657515,0.7241907640463761,66,40,14,23,17,17,24,17,8,9
"wisconsin_exoplanets-falcon10,wisconsin_exoplanets-openaio1,wisconsin_exoplanets-qwq","1,2,1",0.6031746031746031,0.47200694631116646,0.724308882224939,63,38,0.6515151515151515,0.5242397683271001,0.7647080305896783,66,43,14,18,17,9,24,25,8,14
"wisconsin_exoplanets-anthropic3710,wisconsin_exoplanets-openai10o1,wisconsin_exoplanets-phi","5,5,1",0.6031746031746031,0.47200694631116646,0.724308882224939,63,38,0.696969696969697,0.5714834854226349,0.8041003533935258,66,46,20,30,23,18,18,16,2,2
"wisconsin_exoplanets-anthropic3710,wisconsin_exoplanets-openai10,wisconsin_exoplanets-phi","5,5,1",0.6031746031746031,0.47200694631116646,0.724308882224939,63,38,0.7121212121212122,0.5874932401392494,0.816959774581892,66,47,19,31,22,18,19,16,3,1
"wisconsin_exoplanets-deepseek,wisconsin_exoplanets-llamaphi,wisconsin_exoplanets-openai10","1,1,5",0.6031746031746031,0.47200694631116646,0.724308882224939,63,38,0.6060606060606061,0.47809031269657515,0.7241907640463761,66,40,14,23,17,17,24,17,8,9
"wisconsin_exoplanets-falcon10,wisconsin_exoplanets-gemini,wisconsin_exoplanets-openai45","1,7,4",0.6031746031746031,0.47200694631116646,0.724308882224939,63,38,0.6060606060606061,0.47809031269657515,0.7241907640463761,66,40,19,25,22,19,19,15,3,7
"wisconsin_exoplanets-anthropic,wisconsin_exoplanets-openai45,wisconsin_exoplanets-phi","2,4,1",0.6031746031746031,0.47200694631116646,0.724308882224939,63,38,0.7121212121212122,0.5874932401392494,0.816959774581892,66,47,21,28,24,15,17,19,1,4
"wisconsin_exoplanets-anthropic10,wisconsin_exoplanets-falcon10,wisconsin_exoplanets-openai4510","1,1,2",0.6031746031746031,0.47200694631116646,0.724308882224939,63,38,0.6212121212121212,0.4933571772023376,0.7378154230046878,66,41,10,18,13,11,28,23,12,14
"wisconsin_exoplanets-falcon10,wisconsin_exoplanets-gemini,wisconsin_exoplanets-openai","1,7,6",0.6031746031746031,0.47200694631116646,0.724308882224939,63,38,0.6060606060606061,0.47809031269657515,0.7241907640463761,66,40,19,26,22,20,19,14,3,6
"wisconsin_exoplanets-anthropic10,wisconsin_exoplanets-anthropic37,wisconsin_exoplanets-falcon","1,2,1",0.6031746031746031,0.47200694631116646,0.724308882224939,63,38,0.5909090909090909,0.46293656355858825,0.7104508976039902,66,39,13,20,16,15,25,19,9,12
"wisconsin_exoplanets-falcon10,wisconsin_exoplanets-gemini,wisconsin_exoplanets-openailong","1,7,4",0.6031746031746031,0.47200694631116646,0.724308882224939,63,38,0.5909090909090909,0.46293656355858825,0.7104508976039902,66,39,19,25,22,20,19,14,3,7
"wisconsin_exoplanets-falcon10,wisconsin_exoplanets-gemini10,wisconsin_exoplanets-openailong","1,2,4",0.6031746031746031,0.47200694631116646,0.724308882224939,63,38,0.6060606060606061,0.47809031269657515,0.7241907640463761,66,40,14,21,17,15,24,19,8,11
"wisconsin_exoplanets-gemini10,wisconsin_exoplanets-phi,wisconsin_exoplanets-qwq","2,1,1",0.6031746031746031,0.47200694631116646,0.724308882224939,63,38,0.6060606060606061,0.47809031269657515,0.7241907640463761,66,40,6,13,9,7,32,27,16,19
"wisconsin_exoplanets-anthropic10,wisconsin_exoplanets-falcon,wisconsin_exoplanets-openaio1","1,1,2",0.6031746031746031,0.47200694631116646,0.724308882224939,63,38,0.5909090909090909,0.46293656355858825,0.7104508976039902,66,39,13,18,16,13,25,21,9,14
"wisconsin_exoplanets-gemma,wisconsin_exoplanets-llamaphi,wisconsin_exoplanets-openailong","1,1,4",0.6031746031746031,0.47200694631116646,0.724308882224939,63,38,0.45454545454545453,0.3314393816209253,0.5818631668533873,66,30,15,13,18,17,23,17,7,19
"wisconsin_exoplanets-anthropic10,wisconsin_exoplanets-anthropic37,wisconsin_exoplanets-openai10","1,2,5",0.6031746031746031,0.47200694631116646,0.724308882224939,63,38,0.6666666666666666,0.5398613431497497,0.7779692372780057,66,44,21,32,24,22,17,12,1,0
"wisconsin_exoplanets-falcon10,wisconsin_exoplanets-openai10o1,wisconsin_exoplanets-openai4510","1,5,2",0.6031746031746031,0.47200694631116646,0.724308882224939,63,38,0.696969696969697,0.5714834854226349,0.8041003533935258,66,46,16,25,19,13,22,21,6,7
"wisconsin_exoplanets-llamaphi,wisconsin_exoplanets-openai,wisconsin_exoplanets-qwq","1,6,1",0.6,0.45179402847918043,0.7359216049054632,50,30,0.6140350877192983,0.4757484152435112,0.7400453190018772,57,35,13,23,20,16,17,12,0,6
"wisconsin_exoplanets-llamaphi,wisconsin_exoplanets-openai,wisconsin_exoplanets-openai10","1,6,5",0.6,0.45179402847918043,0.7359216049054632,50,30,0.6491228070175439,0.5113133824931495,0.7708544028317619,57,37,12,24,19,15,18,13,1,5
"wisconsin_exoplanets-llamaphi,wisconsin_exoplanets-openai,wisconsin_exoplanets-openaio1","1,6,2",0.6,0.45179402847918043,0.7359216049054632,50,30,0.6491228070175439,0.5113133824931495,0.7708544028317619,57,37,13,24,20,15,17,13,0,5
"wisconsin_exoplanets-falcon10,wisconsin_exoplanets-gemini,wisconsin_exoplanets-openai10o1","1,7,5",0.5873015873015873,0.4561768432495709,0.7099403576024554,63,37,0.6363636363636364,0.5087394315103153,0.7513222169426668,66,42,18,26,22,18,19,16,4,6
"wisconsin_exoplanets-falcon10,wisconsin_exoplanets-gemini,wisconsin_exoplanets-openai10","1,7,5",0.5873015873015873,0.4561768432495709,0.7099403576024554,63,37,0.6060606060606061,0.47809031269657515,0.7241907640463761,66,40,19,26,23,20,18,14,3,6
"wisconsin_exoplanets-gemini,wisconsin_exoplanets-openailong,wisconsin_exoplanets-qwq","7,4,1",0.5873015873015873,0.4561768432495709,0.7099403576024554,63,37,0.5606060606060606,0.43296119670295957,0.6826341362307495,66,37,18,23,22,20,19,14,4,9
"wisconsin_exoplanets-llama,wisconsin_exoplanets-llamaphi,wisconsin_exoplanets-openai45","2,1,4",0.5873015873015873,0.4561768432495709,0.7099403576024554,63,37,0.5606060606060606,0.43296119670295957,0.6826341362307495,66,37,14,21,18,18,23,16,8,11
"wisconsin_exoplanets-anthropic10,wisconsin_exoplanets-openai4510,wisconsin_exoplanets-phi","1,2,1",0.5873015873015873,0.4561768432495709,0.7099403576024554,63,37,0.5151515151515151,0.3888102652777774,0.6400892442500232,66,34,8,11,12,11,29,23,14,21
"wisconsin_exoplanets-geminipro10,wisconsin_exoplanets-openai,wisconsin_exoplanets-qwq","3,6,1",0.5873015873015873,0.4561768432495709,0.7099403576024554,63,37,0.5,0.37430716945155507,0.6256928305484449,66,33,13,13,17,14,24,20,9,19
"wisconsin_exoplanets-anthropic10,wisconsin_exoplanets-openai4510,wisconsin_exoplanets-qwq","1,2,1",0.5873015873015873,0.4561768432495709,0.7099403576024554,63,37,0.5151515151515151,0.3888102652777774,0.6400892442500232,66,34,6,12,10,12,31,22,16,20
"wisconsin_exoplanets-llama,wisconsin_exoplanets-llamaphi,wisconsin_exoplanets-openai10","2,1,5",0.5873015873015873,0.4561768432495709,0.7099403576024554,63,37,0.5757575757575758,0.4478940377087594,0.6965980669616616,66,38,14,22,18,18,23,16,8,10
"wisconsin_exoplanets-gemini,wisconsin_exoplanets-openai45,wisconsin_exoplanets-qwq","7,4,1",0.5873015873015873,0.4561768432495709,0.7099403576024554,63,37,0.5757575757575758,0.4478940377087594,0.6965980669616616,66,38,18,23,22,19,19,15,4,9
"wisconsin_exoplanets-anthropic10,wisconsin_exoplanets-geminipro10,wisconsin_exoplanets-phi","1,3,1",0.5873015873015873,0.4561768432495709,0.7099403576024554,63,37,0.5,0.37430716945155507,0.6256928305484449,66,33,8,11,12,12,29,22,14,21
"wisconsin_exoplanets-deepseek,wisconsin_exoplanets-falcon,wisconsin_exoplanets-geminipro10","1,1,3",0.5873015873015873,0.4561768432495709,0.7099403576024554,63,37,0.6212121212121212,0.4933571772023376,0.7378154230046878,66,41,8,11,12,4,29,30,14,21
"wisconsin_exoplanets-falcon10,wisconsin_exoplanets-geminipro10,wisconsin_exoplanets-llamaphi","1,3,1",0.5873015873015873,0.4561768432495709,0.7099403576024554,63,37,0.5909090909090909,0.46293656355858825,0.7104508976039902,66,39,14,22,18,17,23,17,8,10
"wisconsin_exoplanets-anthropic,wisconsin_exoplanets-anthropic10,wisconsin_exoplanets-phi","2,1,1",0.5873015873015873,0.4561768432495709,0.7099403576024554,63,37,0.6818181818181818,0.5556078292305275,0.7911016327585585,66,45,14,24,18,13,23,21,8,8
"wisconsin_exoplanets-gemma,wisconsin_exoplanets-openai10o1,wisconsin_exoplanets-openailong","1,5,4",0.5873015873015873,0.4561768432495709,0.7099403576024554,63,37,0.4393939393939394,0.31736586376925047,0.5670388032970404,66,29,13,11,17,16,24,18,9,21
"wisconsin_exoplanets-falcon10,wisconsin_exoplanets-geminipro,wisconsin_exoplanets-openailong","1,2,4",0.5873015873015873,0.4561768432495709,0.7099403576024554,63,37,0.5909090909090909,0.46293656355858825,0.7104508976039902,66,39,13,21,17,16,24,18,9,11
"wisconsin_exoplanets-gemini10,wisconsin_exoplanets-openai,wisconsin_exoplanets-phi","2,6,1",0.5873015873015873,0.4561768432495709,0.7099403576024554,63,37,0.6212121212121212,0.4933571772023376,0.7378154230046878,66,41,14,20,18,13,23,21,8,12
"wisconsin_exoplanets-gemini10,wisconsin_exoplanets-gemma,wisconsin_exoplanets-openai10","2,1,5",0.5873015873015873,0.4561768432495709,0.7099403576024554,63,37,0.5606060606060606,0.43296119670295957,0.6826341362307495,66,37,13,16,17,13,24,21,9,16
"wisconsin_exoplanets-anthropic10,wisconsin_exoplanets-deepseek,wisconsin_exoplanets-gemma","1,1,1",0.5873015873015873,0.4561768432495709,0.7099403576024554,63,37,0.5454545454545454,0.4181368331466126,0.6685606183790747,66,36,11,18,15,16,26,18,11,14
"wisconsin_exoplanets-anthropic10,wisconsin_exoplanets-openai,wisconsin_exoplanets-openai4510","1,6,2",0.5873015873015873,0.4561768432495709,0.7099403576024554,63,37,0.5909090909090909,0.46293656355858825,0.7104508976039902,66,39,15,23,19,18,22,16,7,9
"wisconsin_exoplanets-gemma,wisconsin_exoplanets-openai,wisconsin_exoplanets-openai10","1,6,5",0.5873015873015873,0.4561768432495709,0.7099403576024554,63,37,0.4696969696969697,0.345621302763221,0.5965799465582751,66,31,14,13,18,16,23,18,8,19
"wisconsin_exoplanets-anthropic10,wisconsin_exoplanets-openai,wisconsin_exoplanets-openaio1","1,6,2",0.5873015873015873,0.4561768432495709,0.7099403576024554,63,37,0.5303030303030303,0.403420053441725,0.654378697236779,66,35,19,22,23,21,18,13,3,10
"wisconsin_exoplanets-gemma,wisconsin_exoplanets-llamaphi,wisconsin_exoplanets-openai45","1,1,4",0.5873015873015873,0.4561768432495709,0.7099403576024554,63,37,0.45454545454545453,0.3314393816209253,0.5818631668533873,66,30,15,13,19,17,22,17,7,19
"wisconsin_exoplanets-geminipro10,wisconsin_exoplanets-gemma,wisconsin_exoplanets-openai45","3,1,4",0.5873015873015873,0.4561768432495709,0.7099403576024554,63,37,0.5454545454545454,0.4181368331466126,0.6685606183790747,66,36,15,14,19,12,22,22,7,18
"wisconsin_exoplanets-deepseek,wisconsin_exoplanets-falcon10,wisconsin_exoplanets-llama","1,1,2",0.5873015873015873,0.4561768432495709,0.7099403576024554,63,37,0.6363636363636364,0.5087394315103153,0.7513222169426668,66,42,12,23,16,15,25,19,10,9
"wisconsin_exoplanets-gemma,wisconsin_exoplanets-llama,wisconsin_exoplanets-qwq","1,2,1",0.5873015873015873,0.4561768432495709,0.7099403576024554,63,37,0.5,0.37430716945155507,0.6256928305484449,66,33,13,15,17,16,24,18,9,17
"wisconsin_exoplanets-gemma,wisconsin_exoplanets-openai10,wisconsin_exoplanets-openai45","1,5,4",0.5873015873015873,0.4561768432495709,0.7099403576024554,63,37,0.48484848484848486,0.3599107557499768,0.6111897347222226,66,32,13,11,17,13,24,21,9,21
"wisconsin_exoplanets-gemma,wisconsin_exoplanets-llama,wisconsin_exoplanets-openailong","1,2,4",0.5873015873015873,0.4561768432495709,0.7099403576024554,63,37,0.48484848484848486,0.3599107557499768,0.6111897347222226,66,32,18,22,22,24,19,10,4,10
"wisconsin_exoplanets-gemma,wisconsin_exoplanets-llama,wisconsin_exoplanets-openai45","1,2,4",0.5873015873015873,0.4561768432495709,0.7099403576024554,63,37,0.48484848484848486,0.3599107557499768,0.6111897347222226,66,32,18,22,22,24,19,10,4,10
"wisconsin_exoplanets-geminipro10,wisconsin_exoplanets-gemma,wisconsin_exoplanets-qwq","3,1,1",0.5873015873015873,0.4561768432495709,0.7099403576024554,63,37,0.5303030303030303,0.403420053441725,0.654378697236779,66,35,7,7,11,6,30,28,15,25
"wisconsin_exoplanets-gemini10,wisconsin_exoplanets-gemma,wisconsin_exoplanets-openailong","2,1,4",0.5873015873015873,0.4561768432495709,0.7099403576024554,63,37,0.5454545454545454,0.4181368331466126,0.6685606183790747,66,36,13,15,17,13,24,21,9,17
"wisconsin_exoplanets-anthropic10,wisconsin_exoplanets-deepseek,wisconsin_exoplanets-gemini10","1,1,2",0.5873015873015873,0.4561768432495709,0.7099403576024554,63,37,0.6060606060606061,0.47809031269657515,0.7241907640463761,66,40,5,13,9,7,32,27,17,19
"wisconsin_exoplanets-falcon,wisconsin_exoplanets-falcon10,wisconsin_exoplanets-geminipro10","1,1,3",0.5873015873015873,0.4561768432495709,0.7099403576024554,63,37,0.5909090909090909,0.46293656355858825,0.7104508976039902,66,39,9,13,13,8,28,26,13,19
"wisconsin_exoplanets-anthropic10,wisconsin_exoplanets-falcon10,wisconsin_exoplanets-geminipro10","1,1,3",0.5873015873015873,0.4561768432495709,0.7099403576024554,63,37,0.5606060606060606,0.43296119670295957,0.6826341362307495,66,37,10,14,14,11,27,23,12,18
"wisconsin_exoplanets-anthropic3710,wisconsin_exoplanets-falcon,wisconsin_exoplanets-qwq","5,1,1",0.5873015873015873,0.4561768432495709,0.7099403576024554,63,37,0.5909090909090909,0.46293656355858825,0.7104508976039902,66,39,9,17,13,12,28,22,13,15
"wisconsin_exoplanets-deepseek,wisconsin_exoplanets-gemma,wisconsin_exoplanets-qwq","1,1,1",0.5873015873015873,0.4561768432495709,0.7099403576024554,63,37,0.5,0.37430716945155507,0.6256928305484449,66,33,13,13,17,14,24,20,9,19
"wisconsin_exoplanets-gemini,wisconsin_exoplanets-gemma,wisconsin_exoplanets-openai10","7,1,5",0.5873015873015873,0.4561768432495709,0.7099403576024554,63,37,0.5909090909090909,0.46293656355858825,0.7104508976039902,66,39,18,23,22,18,19,16,4,9
"wisconsin_exoplanets-anthropic,wisconsin_exoplanets-openai10,wisconsin_exoplanets-phi","2,5,1",0.5873015873015873,0.4561768432495709,0.7099403576024554,63,37,0.7121212121212122,0.5874932401392494,0.816959774581892,66,47,20,28,24,15,17,19,2,4
"wisconsin_exoplanets-falcon,wisconsin_exoplanets-openai,wisconsin_exoplanets-openaio1","1,6,2",0.5873015873015873,0.4561768432495709,0.7099403576024554,63,37,0.5909090909090909,0.46293656355858825,0.7104508976039902,66,39,20,22,24,17,17,17,2,10
"wisconsin_exoplanets-geminipro,wisconsin_exoplanets-gemma,wisconsin_exoplanets-openailong","2,1,4",0.5873015873015873,0.4561768432495709,0.7099403576024554,63,37,0.48484848484848486,0.3599107557499768,0.6111897347222226,66,32,14,11,18,13,23,21,8,21
"wisconsin_exoplanets-falcon,wisconsin_exoplanets-geminipro10,wisconsin_exoplanets-gemma","1,3,1",0.5873015873015873,0.4561768432495709,0.7099403576024554,63,37,0.4696969696969697,0.345621302763221,0.5965799465582751,66,31,7,6,11,9,30,25,15,26
"wisconsin_exoplanets-falcon,wisconsin_exoplanets-openai45,wisconsin_exoplanets-openaio1","1,4,2",0.5873015873015873,0.4561768432495709,0.7099403576024554,63,37,0.6060606060606061,0.47809031269657515,0.7241907640463761,66,40,20,23,24,17,17,17,2,9
"wisconsin_exoplanets-anthropic,wisconsin_exoplanets-llamaphi,wisconsin_exoplanets-phi","2,1,1",0.5873015873015873,0.4561768432495709,0.7099403576024554,63,37,0.6666666666666666,0.5398613431497497,0.7779692372780057,66,44,20,27,24,17,17,17,2,5
"wisconsin_exoplanets-anthropic,wisconsin_exoplanets-anthropic10,wisconsin_exoplanets-llamaphi","2,1,1",0.5873015873015873,0.4561768432495709,0.7099403576024554,63,37,0.5909090909090909,0.46293656355858825,0.7104508976039902,66,39,19,28,23,23,18,11,3,4
"wisconsin_exoplanets-anthropic10,wisconsin_exoplanets-gemini,wisconsin_exoplanets-qwq","1,7,1",0.5873015873015873,0.4561768432495709,0.7099403576024554,63,37,0.5606060606060606,0.43296119670295957,0.6826341362307495,66,37,11,17,15,14,26,20,11,15
"wisconsin_exoplanets-geminipro,wisconsin_exoplanets-gemma,wisconsin_exoplanets-openai10","2,1,5",0.5873015873015873,0.4561768432495709,0.7099403576024554,63,37,0.5,0.37430716945155507,0.6256928305484449,66,33,14,12,18,13,23,21,8,20
"wisconsin_exoplanets-falcon10,wisconsin_exoplanets-openai,wisconsin_exoplanets-openai10o1","1,6,5",0.5873015873015873,0.4561768432495709,0.7099403576024554,63,37,0.5606060606060606,0.43296119670295957,0.6826341362307495,66,37,14,21,18,18,23,16,8,11
"wisconsin_exoplanets-falcon,wisconsin_exoplanets-geminipro,wisconsin_exoplanets-llama","1,2,2",0.5873015873015873,0.4561768432495709,0.7099403576024554,63,37,0.5151515151515151,0.3888102652777774,0.6400892442500232,66,34,7,10,11,10,30,24,15,22
"wisconsin_exoplanets-deepseek,wisconsin_exoplanets-llamaphi,wisconsin_exoplanets-openai45","1,1,4",0.5873015873015873,0.4561768432495709,0.7099403576024554,63,37,0.6212121212121212,0.4933571772023376,0.7378154230046878,66,41,14,23,18,16,23,18,8,9
"wisconsin_exoplanets-llama,wisconsin_exoplanets-openai10,wisconsin_exoplanets-openai10o1","2,5,5",0.5873015873015873,0.4561768432495709,0.7099403576024554,63,37,0.5757575757575758,0.4478940377087594,0.6965980669616616,66,38,13,22,17,18,24,16,9,10
"wisconsin_exoplanets-falcon10,wisconsin_exoplanets-llama,wisconsin_exoplanets-openai","1,2,6",0.5873015873015873,0.4561768432495709,0.7099403576024554,63,37,0.6060606060606061,0.47809031269657515,0.7241907640463761,66,40,20,28,24,22,17,12,2,4
"wisconsin_exoplanets-falcon,wisconsin_exoplanets-openailong,wisconsin_exoplanets-openaio1","1,4,2",0.5873015873015873,0.4561768432495709,0.7099403576024554,63,37,0.6060606060606061,0.47809031269657515,0.7241907640463761,66,40,20,23,24,17,17,17,2,9
"wisconsin_exoplanets-geminipro,wisconsin_exoplanets-phi,wisconsin_exoplanets-qwq","2,1,1",0.5873015873015873,0.4561768432495709,0.7099403576024554,63,37,0.5303030303030303,0.403420053441725,0.654378697236779,66,35,6,8,10,7,31,27,16,24
"wisconsin_exoplanets-falcon10,wisconsin_exoplanets-openai45,wisconsin_exoplanets-openailong","1,4,4",0.5873015873015873,0.4561768432495709,0.7099403576024554,63,37,0.5909090909090909,0.46293656355858825,0.7104508976039902,66,39,13,20,17,15,24,19,9,12
"wisconsin_exoplanets-anthropic3710,wisconsin_exoplanets-falcon,wisconsin_exoplanets-openailong","5,1,4",0.5873015873015873,0.4561768432495709,0.7099403576024554,63,37,0.6363636363636364,0.5087394315103153,0.7513222169426668,66,42,20,28,24,20,17,14,2,4
"wisconsin_exoplanets-deepseek,wisconsin_exoplanets-falcon,wisconsin_exoplanets-geminipro","1,1,2",0.5873015873015873,0.4561768432495709,0.7099403576024554,63,37,0.6060606060606061,0.47809031269657515,0.7241907640463761,66,40,6,10,10,4,31,30,16,22
"wisconsin_exoplanets-falcon10,wisconsin_exoplanets-geminipro10,wisconsin_exoplanets-openai45","1,3,4",0.5873015873015873,0.4561768432495709,0.7099403576024554,63,37,0.6212121212121212,0.4933571772023376,0.7378154230046878,66,41,15,22,19,15,22,19,7,10
"wisconsin_exoplanets-anthropic37,wisconsin_exoplanets-falcon,wisconsin_exoplanets-openai10o1","2,1,5",0.5873015873015873,0.4561768432495709,0.7099403576024554,63,37,0.6363636363636364,0.5087394315103153,0.7513222169426668,66,42,19,27,23,19,18,15,3,5
"wisconsin_exoplanets-falcon10,wisconsin_exoplanets-openai10,wisconsin_exoplanets-openai4510","1,5,2",0.5873015873015873,0.4561768432495709,0.7099403576024554,63,37,0.6666666666666666,0.5398613431497497,0.7779692372780057,66,44,15,26,19,16,22,18,7,6
"wisconsin_exoplanets-llamaphi,wisconsin_exoplanets-openai,wisconsin_exoplanets-openai4510","1,6,2",0.58,0.4320604350655657,0.7181177588763025,50,29,0.6491228070175439,0.5113133824931495,0.7708544028317619,57,37,13,23,21,14,16,14,0,6
"wisconsin_exoplanets-falcon,wisconsin_exoplanets-gemini,wisconsin_exoplanets-openai","1,7,6",0.5714285714285714,0.4404709678767688,0.6954456595353613,63,36,0.6363636363636364,0.5087394315103153,0.7513222169426668,66,42,19,25,24,17,17,17,3,7
"wisconsin_exoplanets-falcon10,wisconsin_exoplanets-gemini10,wisconsin_exoplanets-openai10","1,2,5",0.5714285714285714,0.4404709678767688,0.6954456595353613,63,36,0.6212121212121212,0.4933571772023376,0.7378154230046878,66,41,13,22,18,15,23,19,9,10
"wisconsin_exoplanets-gemini10,wisconsin_exoplanets-gemma,wisconsin_exoplanets-qwq","2,1,1",0.5714285714285714,0.4404709678767688,0.6954456595353613,63,36,0.5454545454545454,0.4181368331466126,0.6685606183790747,66,36,5,7,10,5,31,29,17,25
"wisconsin_exoplanets-falcon10,wisconsin_exoplanets-llamaphi,wisconsin_exoplanets-openai10o1","1,1,5",0.5714285714285714,0.4404709678767688,0.6954456595353613,63,36,0.5454545454545454,0.4181368331466126,0.6685606183790747,66,36,14,21,19,19,22,15,8,11
"wisconsin_exoplanets-deepseek,wisconsin_exoplanets-gemma,wisconsin_exoplanets-phi","1,1,1",0.5714285714285714,0.4404709678767688,0.6954456595353613,63,36,0.5454545454545454,0.4181368331466126,0.6685606183790747,66,36,12,16,17,14,24,20,10,16
"wisconsin_exoplanets-deepseek,wisconsin_exoplanets-gemma,wisconsin_exoplanets-openailong","1,1,4",0.5714285714285714,0.4404709678767688,0.6954456595353613,63,36,0.5606060606060606,0.43296119670295957,0.6826341362307495,66,37,17,25,22,22,19,12,5,7
"wisconsin_exoplanets-falcon10,wisconsin_exoplanets-gemini10,wisconsin_exoplanets-openai10o1","1,2,5",0.5714285714285714,0.4404709678767688,0.6954456595353613,63,36,0.6666666666666666,0.5398613431497497,0.7779692372780057,66,44,13,22,18,12,23,22,9,10
"wisconsin_exoplanets-gemma,wisconsin_exoplanets-llamaphi,wisconsin_exoplanets-openai10","1,1,5",0.5714285714285714,0.4404709678767688,0.6954456595353613,63,36,0.45454545454545453,0.3314393816209253,0.5818631668533873,66,30,14,13,19,17,22,17,8,19
"wisconsin_exoplanets-falcon10,wisconsin_exoplanets-openai,wisconsin_exoplanets-openai10","1,6,5",0.5714285714285714,0.4404709678767688,0.6954456595353613,63,36,0.5757575757575758,0.4478940377087594,0.6965980669616616,66,38,14,21,19,17,22,17,8,11
"wisconsin_exoplanets-anthropic10,wisconsin_exoplanets-llamaphi,wisconsin_exoplanets-openaio1","1,1,2",0.5714285714285714,0.4404709678767688,0.6954456595353613,63,36,0.5,0.37430716945155507,0.6256928305484449,66,33,18,21,23,22,18,12,4,11
"wisconsin_exoplanets-gemini,wisconsin_exoplanets-openai10,wisconsin_exoplanets-qwq","7,5,1",0.5714285714285714,0.4404709678767688,0.6954456595353613,63,36,0.5606060606060606,0.43296119670295957,0.6826341362307495,66,37,18,23,23,20,18,14,4,9
"wisconsin_exoplanets-anthropic,wisconsin_exoplanets-openai10o1,wisconsin_exoplanets-phi","2,5,1",0.5714285714285714,0.4404709678767688,0.6954456595353613,63,36,0.6818181818181818,0.5556078292305275,0.7911016327585585,66,45,20,27,25,16,16,18,2,5
"wisconsin_exoplanets-anthropic10,wisconsin_exoplanets-gemini10,wisconsin_exoplanets-qwq","1,2,1",0.5714285714285714,0.4404709678767688,0.6954456595353613,63,36,0.5,0.37430716945155507,0.6256928305484449,66,33,5,10,10,11,31,23,17,22
"wisconsin_exoplanets-anthropic10,wisconsin_exoplanets-gemma,wisconsin_exoplanets-llama","1,1,2",0.5714285714285714,0.4404709678767688,0.6954456595353613,63,36,0.45454545454545453,0.3314393816209253,0.5818631668533873,66,30,13,15,18,19,23,15,9,17
"wisconsin_exoplanets-geminipro10,wisconsin_exoplanets-llamaphi,wisconsin_exoplanets-qwq","3,1,1",0.5714285714285714,0.4404709678767688,0.6954456595353613,63,36,0.45454545454545453,0.3314393816209253,0.5818631668533873,66,30,12,12,17,16,24,18,10,20
"wisconsin_exoplanets-geminipro,wisconsin_exoplanets-openai,wisconsin_exoplanets-qwq","2,6,1",0.5714285714285714,0.4404709678767688,0.6954456595353613,63,36,0.5,0.37430716945155507,0.6256928305484449,66,33,11,13,16,14,25,20,11,19
"wisconsin_exoplanets-falcon,wisconsin_exoplanets-falcon10,wisconsin_exoplanets-geminipro","1,1,2",0.5714285714285714,0.4404709678767688,0.6954456595353613,63,36,0.5606060606060606,0.43296119670295957,0.6826341362307495,66,37,7,11,12,8,29,26,15,21
"wisconsin_exoplanets-falcon10,wisconsin_exoplanets-openai10,wisconsin_exoplanets-openai45","1,5,4",0.5714285714285714,0.4404709678767688,0.6954456595353613,63,36,0.6060606060606061,0.47809031269657515,0.7241907640463761,66,40,13,21,18,15,23,19,9,11
"wisconsin_exoplanets-geminipro10,wisconsin_exoplanets-openai45,wisconsin_exoplanets-qwq","3,4,1",0.5714285714285714,0.4404709678767688,0.6954456595353613,63,36,0.5151515151515151,0.3888102652777774,0.6400892442500232,66,34,13,14,18,14,23,20,9,18
"wisconsin_exoplanets-falcon,wisconsin_exoplanets-falcon10,wisconsin_exoplanets-gemini10","1,1,2",0.5714285714285714,0.4404709678767688,0.6954456595353613,63,36,0.5757575757575758,0.4478940377087594,0.6965980669616616,66,38,6,12,11,8,30,26,16,20
"wisconsin_exoplanets-falcon10,wisconsin_exoplanets-openai4510,wisconsin_exoplanets-qwq","1,2,1",0.5714285714285714,0.4404709678767688,0.6954456595353613,63,36,0.5909090909090909,0.46293656355858825,0.7104508976039902,66,39,7,13,12,8,29,26,15,19
"wisconsin_exoplanets-deepseek,wisconsin_exoplanets-llama,wisconsin_exoplanets-openai","1,2,6",0.5714285714285714,0.4404709678767688,0.6954456595353613,63,36,0.6212121212121212,0.4933571772023376,0.7378154230046878,66,41,18,28,23,21,18,13,4,4
"wisconsin_exoplanets-gemma,wisconsin_exoplanets-llama,wisconsin_exoplanets-openai","1,2,6",0.5714285714285714,0.4404709678767688,0.6954456595353613,63,36,0.5,0.37430716945155507,0.6256928305484449,66,33,18,21,23,22,18,12,4,11
"wisconsin_exoplanets-gemma,wisconsin_exoplanets-llama,wisconsin_exoplanets-openai10","1,2,5",0.5714285714285714,0.4404709678767688,0.6954456595353613,63,36,0.5,0.37430716945155507,0.6256928305484449,66,33,17,23,22,24,19,10,5,9
"wisconsin_exoplanets-anthropic,wisconsin_exoplanets-anthropic10,wisconsin_exoplanets-openailong","2,1,4",0.5714285714285714,0.4404709678767688,0.6954456595353613,63,36,0.6666666666666666,0.5398613431497497,0.7779692372780057,66,44,19,30,24,20,17,14,3,2
"wisconsin_exoplanets-falcon10,wisconsin_exoplanets-openai,wisconsin_exoplanets-openailong","1,6,4",0.5714285714285714,0.4404709678767688,0.6954456595353613,63,36,0.5757575757575758,0.4478940377087594,0.6965980669616616,66,38,14,21,19,17,22,17,8,11
"wisconsin_exoplanets-anthropic,wisconsin_exoplanets-anthropic10,wisconsin_exoplanets-falcon","2,1,1",0.5714285714285714,0.4404709678767688,0.6954456595353613,63,36,0.6060606060606061,0.47809031269657515,0.7241907640463761,66,40,13,19,18,13,23,21,9,13
"wisconsin_exoplanets-gemma,wisconsin_exoplanets-llama,wisconsin_exoplanets-phi","1,2,1",0.5714285714285714,0.4404709678767688,0.6954456595353613,63,36,0.45454545454545453,0.3314393816209253,0.5818631668533873,66,30,14,12,19,16,22,18,8,20
"wisconsin_exoplanets-geminipro10,wisconsin_exoplanets-gemma,wisconsin_exoplanets-openailong","3,1,4",0.5714285714285714,0.4404709678767688,0.6954456595353613,63,36,0.5303030303030303,0.403420053441725,0.654378697236779,66,35,14,14,19,13,22,21,8,18
"wisconsin_exoplanets-falcon,wisconsin_exoplanets-gemini,wisconsin_exoplanets-qwq","1,7,1",0.5714285714285714,0.4404709678767688,0.6954456595353613,63,36,0.5303030303030303,0.403420053441725,0.654378697236779,66,35,11,11,16,10,25,24,11,21
"wisconsin_exoplanets-anthropic,wisconsin_exoplanets-falcon,wisconsin_exoplanets-openai","2,1,6",0.5714285714285714,0.4404709678767688,0.6954456595353613,63,36,0.6666666666666666,0.5398613431497497,0.7779692372780057,66,44,19,27,24,17,17,17,3,5
"wisconsin_exoplanets-gemini,wisconsin_exoplanets-openai10o1,wisconsin_exoplanets-qwq","7,5,1",0.5714285714285714,0.4404709678767688,0.6954456595353613,63,36,0.5606060606060606,0.43296119670295957,0.6826341362307495,66,37,18,21,23,18,18,16,4,11
"wisconsin_exoplanets-anthropic10,wisconsin_exoplanets-openailong,wisconsin_exoplanets-openaio1","1,4,2",0.5714285714285714,0.4404709678767688,0.6954456595353613,63,36,0.5303030303030303,0.403420053441725,0.654378697236779,66,35,18,22,23,21,18,13,4,10
"wisconsin_exoplanets-falcon,wisconsin_exoplanets-geminipro,wisconsin_exoplanets-gemma","1,2,1",0.5714285714285714,0.4404709678767688,0.6954456595353613,63,36,0.4393939393939394,0.31736586376925047,0.5670388032970404,66,29,4,4,9,9,32,25,18,28
"wisconsin_exoplanets-anthropic10,wisconsin_exoplanets-anthropic3710,wisconsin_exoplanets-openai10o1","1,5,5",0.5714285714285714,0.4404709678767688,0.6954456595353613,63,36,0.6666666666666666,0.5398613431497497,0.7779692372780057,66,44,18,30,23,20,18,14,4,2
"wisconsin_exoplanets-anthropic10,wisconsin_exoplanets-anthropic3710,wisconsin_exoplanets-openailong","1,5,4",0.5714285714285714,0.4404709678767688,0.6954456595353613,63,36,0.6363636363636364,0.5087394315103153,0.7513222169426668,66,42,18,30,23,22,18,12,4,2
"wisconsin_exoplanets-geminipro10,wisconsin_exoplanets-gemma,wisconsin_exoplanets-openai10","3,1,5",0.5714285714285714,0.4404709678767688,0.6954456595353613,63,36,0.5454545454545454,0.4181368331466126,0.6685606183790747,66,36,14,15,19,13,22,21,8,17
"wisconsin_exoplanets-anthropic,wisconsin_exoplanets-anthropic10,wisconsin_exoplanets-openai45","2,1,4",0.5714285714285714,0.4404709678767688,0.6954456595353613,63,36,0.6666666666666666,0.5398613431497497,0.7779692372780057,66,44,20,30,25,20,16,14,2,2
"wisconsin_exoplanets-anthropic10,wisconsin_exoplanets-openai45,wisconsin_exoplanets-openaio1","1,4,2",0.5714285714285714,0.4404709678767688,0.6954456595353613,63,36,0.5454545454545454,0.4181368331466126,0.6685606183790747,66,36,19,22,24,20,17,14,3,10
"wisconsin_exoplanets-falcon10,wisconsin_exoplanets-geminipro,wisconsin_exoplanets-qwq","1,2,1",0.5714285714285714,0.4404709678767688,0.6954456595353613,63,36,0.5606060606060606,0.43296119670295957,0.6826341362307495,66,37,7,11,12,8,29,26,15,21
"wisconsin_exoplanets-anthropic10,wisconsin_exoplanets-anthropic3710,wisconsin_exoplanets-openai10","1,5,5",0.5714285714285714,0.4404709678767688,0.6954456595353613,63,36,0.6363636363636364,0.5087394315103153,0.7513222169426668,66,42,18,30,23,22,18,12,4,2
"wisconsin_exoplanets-anthropic3710,wisconsin_exoplanets-falcon,wisconsin_exoplanets-openai10o1","5,1,5",0.5714285714285714,0.4404709678767688,0.6954456595353613,63,36,0.6666666666666666,0.5398613431497497,0.7779692372780057,66,44,19,26,24,16,17,18,3,6
"wisconsin_exoplanets-anthropic10,wisconsin_exoplanets-geminipro,wisconsin_exoplanets-qwq","1,2,1",0.5714285714285714,0.4404709678767688,0.6954456595353613,63,36,0.45454545454545453,0.3314393816209253,0.5818631668533873,66,30,5,8,10,12,31,22,17,24
"wisconsin_exoplanets-deepseek,wisconsin_exoplanets-falcon10,wisconsin_exoplanets-qwq","1,1,1",0.5714285714285714,0.4404709678767688,0.6954456595353613,63,36,0.5303030303030303,0.403420053441725,0.654378697236779,66,35,11,17,16,16,25,18,11,15
"wisconsin_exoplanets-falcon10,wisconsin_exoplanets-geminipro,wisconsin_exoplanets-openai10o1","1,2,5",0.5714285714285714,0.4404709678767688,0.6954456595353613,63,36,0.6515151515151515,0.5242397683271001,0.7647080305896783,66,43,13,22,18,13,23,21,9,10
"wisconsin_exoplanets-gemma,wisconsin_exoplanets-openai10o1,wisconsin_exoplanets-openai45","1,5,4",0.5714285714285714,0.4404709678767688,0.6954456595353613,63,36,0.4393939393939394,0.31736586376925047,0.5670388032970404,66,29,13,11,18,16,23,18,9,21
"wisconsin_exoplanets-anthropic10,wisconsin_exoplanets-gemini,wisconsin_exoplanets-openai","1,7,6",0.5714285714285714,0.4404709678767688,0.6954456595353613,63,36,0.5454545454545454,0.4181368331466126,0.6685606183790747,66,36,17,23,22,21,19,13,5,9
"wisconsin_exoplanets-falcon10,wisconsin_exoplanets-llama,wisconsin_exoplanets-phi","1,2,1",0.5714285714285714,0.4404709678767688,0.6954456595353613,63,36,0.5606060606060606,0.43296119670295957,0.6826341362307495,66,37,14,21,19,18,22,16,8,11
"wisconsin_exoplanets-anthropic3710,wisconsin_exoplanets-falcon,wisconsin_exoplanets-openai10","5,1,5",0.5714285714285714,0.4404709678767688,0.6954456595353613,63,36,0.6363636363636364,0.5087394315103153,0.7513222169426668,66,42,19,28,24,20,17,14,3,4
"wisconsin_exoplanets-deepseek,wisconsin_exoplanets-gemma,wisconsin_exoplanets-openai45","1,1,4",0.5714285714285714,0.4404709678767688,0.6954456595353613,63,36,0.5757575757575758,0.4478940377087594,0.6965980669616616,66,38,17,25,22,21,19,13,5,7
"wisconsin_exoplanets-anthropic,wisconsin_exoplanets-anthropic10,wisconsin_exoplanets-openai10o1","2,1,5",0.5714285714285714,0.4404709678767688,0.6954456595353613,63,36,0.6818181818181818,0.5556078292305275,0.7911016327585585,66,45,19,30,24,19,17,15,3,2
"wisconsin_exoplanets-falcon10,wisconsin_exoplanets-gemini10,wisconsin_exoplanets-qwq","1,2,1",0.5714285714285714,0.4404709678767688,0.6954456595353613,63,36,0.5757575757575758,0.4478940377087594,0.6965980669616616,66,38,7,12,12,8,29,26,15,20
"wisconsin_exoplanets-openai4510,wisconsin_exoplanets-openailong,wisconsin_exoplanets-phi","2,4,1",0.5714285714285714,0.4404709678767688,0.6954456595353613,63,36,0.6363636363636364,0.5087394315103153,0.7513222169426668,66,42,15,20,20,12,21,22,7,12
"wisconsin_exoplanets-deepseek,wisconsin_exoplanets-falcon10,wisconsin_exoplanets-openai","1,1,6",0.5714285714285714,0.4404709678767688,0.6954456595353613,63,36,0.5606060606060606,0.43296119670295957,0.6826341362307495,66,37,18,27,23,24,18,10,4,5
"wisconsin_exoplanets-gemma,wisconsin_exoplanets-openai10,wisconsin_exoplanets-openai10o1","1,5,5",0.5714285714285714,0.4404709678767688,0.6954456595353613,63,36,0.4393939393939394,0.31736586376925047,0.5670388032970404,66,29,13,11,18,16,23,18,9,21
"wisconsin_exoplanets-gemma,wisconsin_exoplanets-openai10,wisconsin_exoplanets-openailong","1,5,4",0.5714285714285714,0.4404709678767688,0.6954456595353613,63,36,0.48484848484848486,0.3599107557499768,0.6111897347222226,66,32,12,11,17,13,24,21,10,21
"wisconsin_exoplanets-falcon10,wisconsin_exoplanets-geminipro10,wisconsin_exoplanets-openailong","1,3,4",0.5714285714285714,0.4404709678767688,0.6954456595353613,63,36,0.6060606060606061,0.47809031269657515,0.7241907640463761,66,40,14,22,19,16,22,18,8,10
"wisconsin_exoplanets-llamaphi,wisconsin_exoplanets-openai,wisconsin_exoplanets-phi","1,6,1",0.56,0.4125441229416732,0.7000927790724565,50,28,0.6140350877192983,0.4757484152435112,0.7400453190018772,57,35,12,22,21,15,16,13,1,7
"wisconsin_exoplanets-anthropic10,wisconsin_exoplanets-falcon10,wisconsin_exoplanets-llama","1,1,2",0.5555555555555556,0.4248876269826103,0.680826873728043,63,35,0.5454545454545454,0.4181368331466126,0.6685606183790747,66,36,12,22,18,20,23,14,10,10
"wisconsin_exoplanets-geminipro,wisconsin_exoplanets-openai,wisconsin_exoplanets-phi","2,6,1",0.5555555555555556,0.4248876269826103,0.680826873728043,63,35,0.5151515151515151,0.3888102652777774,0.6400892442500232,66,34,13,14,19,14,22,20,9,18
"wisconsin_exoplanets-geminipro,wisconsin_exoplanets-llamaphi,wisconsin_exoplanets-qwq","2,1,1",0.5555555555555556,0.4248876269826103,0.680826873728043,63,35,0.45454545454545453,0.3314393816209253,0.5818631668533873,66,30,10,12,16,16,25,18,12,20
"wisconsin_exoplanets-falcon,wisconsin_exoplanets-openai10,wisconsin_exoplanets-openaio1","1,5,2",0.5555555555555556,0.4248876269826103,0.680826873728043,63,35,0.6060606060606061,0.47809031269657515,0.7241907640463761,66,40,19,23,25,17,16,17,3,9
"wisconsin_exoplanets-anthropic,wisconsin_exoplanets-anthropic10,wisconsin_exoplanets-openai10","2,1,5",0.5555555555555556,0.4248876269826103,0.680826873728043,63,35,0.6666666666666666,0.5398613431497497,0.7779692372780057,66,44,18,30,24,20,17,14,4,2
"wisconsin_exoplanets-openai4510,wisconsin_exoplanets-openailong,wisconsin_exoplanets-qwq","2,4,1",0.5555555555555556,0.4248876269826103,0.680826873728043,63,35,0.5909090909090909,0.46293656355858825,0.7104508976039902,66,39,12,20,18,15,23,19,10,12
"wisconsin_exoplanets-falcon,wisconsin_exoplanets-falcon10,wisconsin_exoplanets-gemini","1,1,7",0.5555555555555556,0.4248876269826103,0.680826873728043,63,35,0.6212121212121212,0.4933571772023376,0.7378154230046878,66,41,12,20,18,13,23,21,10,12
"wisconsin_exoplanets-falcon,wisconsin_exoplanets-openai4510,wisconsin_exoplanets-qwq","1,2,1",0.5555555555555556,0.4248876269826103,0.680826873728043,63,35,0.5606060606060606,0.43296119670295957,0.6826341362307495,66,37,8,12,14,9,27,25,14,20
"wisconsin_exoplanets-anthropic10,wisconsin_exoplanets-geminipro,wisconsin_exoplanets-phi","1,2,1",0.5555555555555556,0.4248876269826103,0.680826873728043,63,35,0.45454545454545453,0.3314393816209253,0.5818631668533873,66,30,6,8,12,12,29,22,16,24
"wisconsin_exoplanets-falcon,wisconsin_exoplanets-openai4510,wisconsin_exoplanets-phi","1,2,1",0.5555555555555556,0.4248876269826103,0.680826873728043,63,35,0.6212121212121212,0.4933571772023376,0.7378154230046878,66,41,9,13,15,6,26,28,13,19
"wisconsin_exoplanets-deepseek,wisconsin_exoplanets-falcon10,wisconsin_exoplanets-llamaphi","1,1,1",0.5555555555555556,0.4248876269826103,0.680826873728043,63,35,0.5303030303030303,0.403420053441725,0.654378697236779,66,35,17,26,23,25,18,9,5,6
"wisconsin_exoplanets-geminipro,wisconsin_exoplanets-gemma,wisconsin_exoplanets-qwq","2,1,1",0.5555555555555556,0.4248876269826103,0.680826873728043,63,35,0.48484848484848486,0.3599107557499768,0.6111897347222226,66,32,5,4,11,6,30,28,17,28
"wisconsin_exoplanets-geminipro,wisconsin_exoplanets-openai45,wisconsin_exoplanets-qwq","2,4,1",0.5555555555555556,0.4248876269826103,0.680826873728043,63,35,0.5151515151515151,0.3888102652777774,0.6400892442500232,66,34,11,14,17,14,24,20,11,18
"wisconsin_exoplanets-anthropic10,wisconsin_exoplanets-gemini,wisconsin_exoplanets-llamaphi","1,7,1",0.5555555555555556,0.4248876269826103,0.680826873728043,63,35,0.5151515151515151,0.3888102652777774,0.6400892442500232,66,34,16,23,22,23,19,11,6,9
"wisconsin_exoplanets-deepseek,wisconsin_exoplanets-llama,wisconsin_exoplanets-openailong","1,2,4",0.5555555555555556,0.4248876269826103,0.680826873728043,63,35,0.5606060606060606,0.43296119670295957,0.6826341362307495,66,37,18,28,24,25,17,9,4,4
"wisconsin_exoplanets-anthropic10,wisconsin_exoplanets-falcon10,wisconsin_exoplanets-geminipro","1,1,2",0.5555555555555556,0.4248876269826103,0.680826873728043,63,35,0.5606060606060606,0.43296119670295957,0.6826341362307495,66,37,7,14,13,11,28,23,15,18
"wisconsin_exoplanets-falcon10,wisconsin_exoplanets-llamaphi,wisconsin_exoplanets-openai10","1,1,5",0.5555555555555556,0.4248876269826103,0.680826873728043,63,35,0.5606060606060606,0.43296119670295957,0.6826341362307495,66,37,14,21,20,18,21,16,8,11
"wisconsin_exoplanets-falcon,wisconsin_exoplanets-gemini10,wisconsin_exoplanets-qwq","1,2,1",0.5555555555555556,0.4248876269826103,0.680826873728043,63,35,0.5303030303030303,0.403420053441725,0.654378697236779,66,35,7,9,13,8,28,26,15,23
"wisconsin_exoplanets-anthropic10,wisconsin_exoplanets-falcon10,wisconsin_exoplanets-gemini10","1,1,2",0.5555555555555556,0.4248876269826103,0.680826873728043,63,35,0.5909090909090909,0.46293656355858825,0.7104508976039902,66,39,7,15,13,10,28,24,15,17
"wisconsin_exoplanets-anthropic,wisconsin_exoplanets-falcon,wisconsin_exoplanets-openai45","2,1,4",0.5555555555555556,0.4248876269826103,0.680826873728043,63,35,0.6818181818181818,0.5556078292305275,0.7911016327585585,66,45,19,28,25,17,16,17,3,4
"wisconsin_exoplanets-anthropic,wisconsin_exoplanets-falcon,wisconsin_exoplanets-openailong","2,1,4",0.5555555555555556,0.4248876269826103,0.680826873728043,63,35,0.6666666666666666,0.5398613431497497,0.7779692372780057,66,44,19,28,25,18,16,16,3,4
"wisconsin_exoplanets-deepseek,wisconsin_exoplanets-falcon,wisconsin_exoplanets-falcon10","1,1,1",0.5555555555555556,0.4248876269826103,0.680826873728043,63,35,0.6515151515151515,0.5242397683271001,0.7647080305896783,66,43,10,20,16,11,25,23,12,12
"wisconsin_exoplanets-anthropic,wisconsin_exoplanets-falcon,wisconsin_exoplanets-qwq","2,1,1",0.5555555555555556,0.4248876269826103,0.680826873728043,63,35,0.5909090909090909,0.46293656355858825,0.7104508976039902,66,39,11,16,17,11,24,23,11,16
"wisconsin_exoplanets-falcon10,wisconsin_exoplanets-gemma,wisconsin_exoplanets-phi","1,1,1",0.5555555555555556,0.4248876269826103,0.680826873728043,63,35,0.5303030303030303,0.403420053441725,0.654378697236779,66,35,13,15,19,14,22,20,9,17
"wisconsin_exoplanets-falcon10,wisconsin_exoplanets-llama,wisconsin_exoplanets-llamaphi","1,2,1",0.5555555555555556,0.4248876269826103,0.680826873728043,63,35,0.5909090909090909,0.46293656355858825,0.7104508976039902,66,39,19,28,25,23,16,11,3,4
"wisconsin_exoplanets-falcon,wisconsin_exoplanets-gemma,wisconsin_exoplanets-llama","1,1,2",0.5555555555555556,0.4248876269826103,0.680826873728043,63,35,0.48484848484848486,0.3599107557499768,0.6111897347222226,66,32,11,13,17,15,24,19,11,19
"wisconsin_exoplanets-falcon10,wisconsin_exoplanets-llamaphi,wisconsin_exoplanets-openailong","1,1,4",0.5555555555555556,0.4248876269826103,0.680826873728043,63,35,0.5606060606060606,0.43296119670295957,0.6826341362307495,66,37,14,21,20,18,21,16,8,11
"wisconsin_exoplanets-anthropic10,wisconsin_exoplanets-anthropic3710,wisconsin_exoplanets-openai45","1,5,4",0.5555555555555556,0.4248876269826103,0.680826873728043,63,35,0.6363636363636364,0.5087394315103153,0.7513222169426668,66,42,18,30,24,22,17,12,4,2
"wisconsin_exoplanets-falcon10,wisconsin_exoplanets-llamaphi,wisconsin_exoplanets-qwq","1,1,1",0.5555555555555556,0.4248876269826103,0.680826873728043,63,35,0.5303030303030303,0.403420053441725,0.654378697236779,66,35,16,24,22,23,19,11,6,8
"wisconsin_exoplanets-falcon10,wisconsin_exoplanets-openai,wisconsin_exoplanets-openai45","1,6,4",0.5555555555555556,0.4248876269826103,0.680826873728043,63,35,0.5757575757575758,0.4478940377087594,0.6965980669616616,66,38,14,21,20,17,21,17,8,11
"wisconsin_exoplanets-deepseek,wisconsin_exoplanets-llama,wisconsin_exoplanets-llamaphi","1,2,1",0.5555555555555556,0.4248876269826103,0.680826873728043,63,35,0.5757575757575758,0.4478940377087594,0.6965980669616616,66,38,18,27,24,23,17,11,4,5
"wisconsin_exoplanets-falcon,wisconsin_exoplanets-llamaphi,wisconsin_exoplanets-openaio1","1,1,2",0.5555555555555556,0.4248876269826103,0.680826873728043,63,35,0.6060606060606061,0.47809031269657515,0.7241907640463761,66,40,19,23,25,17,16,17,3,9
"wisconsin_exoplanets-falcon10,wisconsin_exoplanets-openai,wisconsin_exoplanets-qwq","1,6,1",0.5555555555555556,0.4248876269826103,0.680826873728043,63,35,0.5303030303030303,0.403420053441725,0.654378697236779,66,35,16,23,22,22,19,12,6,9
"wisconsin_exoplanets-deepseek,wisconsin_exoplanets-llama,wisconsin_exoplanets-openai10o1","1,2,5",0.5555555555555556,0.4248876269826103,0.680826873728043,63,35,0.5606060606060606,0.43296119670295957,0.6826341362307495,66,37,18,27,24,24,17,10,4,5
"wisconsin_exoplanets-falcon10,wisconsin_exoplanets-openai10,wisconsin_exoplanets-openailong","1,5,4",0.5555555555555556,0.4248876269826103,0.680826873728043,63,35,0.6060606060606061,0.47809031269657515,0.7241907640463761,66,40,12,21,18,15,23,19,10,11
"wisconsin_exoplanets-deepseek,wisconsin_exoplanets-llama,wisconsin_exoplanets-openai45","1,2,4",0.5555555555555556,0.4248876269826103,0.680826873728043,63,35,0.5757575757575758,0.4478940377087594,0.6965980669616616,66,38,18,28,24,24,17,10,4,4
"wisconsin_exoplanets-falcon10,wisconsin_exoplanets-openai10o1,wisconsin_exoplanets-openailong","1,5,4",0.5555555555555556,0.4248876269826103,0.680826873728043,63,35,0.5606060606060606,0.43296119670295957,0.6826341362307495,66,37,13,21,19,18,22,16,9,11
"wisconsin_exoplanets-anthropic,wisconsin_exoplanets-falcon,wisconsin_exoplanets-openai10","2,1,5",0.5555555555555556,0.4248876269826103,0.680826873728043,63,35,0.6666666666666666,0.5398613431497497,0.7779692372780057,66,44,19,28,25,18,16,16,3,4
"wisconsin_exoplanets-falcon10,wisconsin_exoplanets-gemma,wisconsin_exoplanets-llama","1,1,2",0.5555555555555556,0.4248876269826103,0.680826873728043,63,35,0.5151515151515151,0.3888102652777774,0.6400892442500232,66,34,13,16,19,16,22,18,9,16
"wisconsin_exoplanets-gemini10,wisconsin_exoplanets-openai,wisconsin_exoplanets-qwq","2,6,1",0.5555555555555556,0.4248876269826103,0.680826873728043,63,35,0.5606060606060606,0.43296119670295957,0.6826341362307495,66,37,10,16,16,13,25,21,12,16
"wisconsin_exoplanets-anthropic10,wisconsin_exoplanets-openai10o1,wisconsin_exoplanets-openaio1","1,5,2",0.5555555555555556,0.4248876269826103,0.680826873728043,63,35,0.5454545454545454,0.4181368331466126,0.6685606183790747,66,36,19,22,25,20,16,14,3,10
"wisconsin_exoplanets-anthropic10,wisconsin_exoplanets-llamaphi,wisconsin_exoplanets-openai4510","1,1,2",0.5555555555555556,0.4248876269826103,0.680826873728043,63,35,0.5606060606060606,0.43296119670295957,0.6826341362307495,66,37,14,23,20,20,21,14,8,9
"wisconsin_exoplanets-gemma,wisconsin_exoplanets-llama,wisconsin_exoplanets-openai10o1","1,2,5",0.5555555555555556,0.4248876269826103,0.680826873728043,63,35,0.5,0.37430716945155507,0.6256928305484449,66,33,17,22,23,23,18,11,5,10
"wisconsin_exoplanets-deepseek,wisconsin_exoplanets-falcon10,wisconsin_exoplanets-phi","1,1,1",0.5555555555555556,0.4248876269826103,0.680826873728043,63,35,0.6212121212121212,0.4933571772023376,0.7378154230046878,66,41,11,21,17,14,24,20,11,11
"wisconsin_exoplanets-geminipro10,wisconsin_exoplanets-openailong,wisconsin_exoplanets-qwq","3,4,1",0.5555555555555556,0.4248876269826103,0.680826873728043,63,35,0.5,0.37430716945155507,0.6256928305484449,66,33,12,14,18,15,23,19,10,18
"wisconsin_exoplanets-falcon10,wisconsin_exoplanets-geminipro,wisconsin_exoplanets-openai10","1,2,5",0.5555555555555556,0.4248876269826103,0.680826873728043,63,35,0.6060606060606061,0.47809031269657515,0.7241907640463761,66,40,12,22,18,16,23,18,10,10
"wisconsin_exoplanets-gemini10,wisconsin_exoplanets-llamaphi,wisconsin_exoplanets-qwq","2,1,1",0.5555555555555556,0.4248876269826103,0.680826873728043,63,35,0.5303030303030303,0.403420053441725,0.654378697236779,66,35,10,16,16,15,25,19,12,16
"wisconsin_exoplanets-anthropic10,wisconsin_exoplanets-openai10,wisconsin_exoplanets-openaio1","1,5,2",0.5555555555555556,0.4248876269826103,0.680826873728043,63,35,0.5303030303030303,0.403420053441725,0.654378697236779,66,35,18,22,24,21,17,13,4,10
"wisconsin_exoplanets-gemini10,wisconsin_exoplanets-llamaphi,wisconsin_exoplanets-phi","2,1,1",0.5555555555555556,0.4248876269826103,0.680826873728043,63,35,0.5909090909090909,0.46293656355858825,0.7104508976039902,66,39,13,19,19,14,22,20,9,13
"wisconsin_exoplanets-anthropic10,wisconsin_exoplanets-gemma,wisconsin_exoplanets-phi","1,1,1",0.5555555555555556,0.4248876269826103,0.680826873728043,63,35,0.4393939393939394,0.31736586376925047,0.5670388032970404,66,29,14,11,20,16,21,18,8,21
"wisconsin_exoplanets-gemma,wisconsin_exoplanets-phi,wisconsin_exoplanets-qwq","1,1,1",0.5555555555555556,0.4248876269826103,0.680826873728043,63,35,0.48484848484848486,0.3599107557499768,0.6111897347222226,66,32,10,11,16,13,25,21,12,21
"wisconsin_exoplanets-anthropic10,wisconsin_exoplanets-openai4510,wisconsin_exoplanets-openailong","1,2,4",0.5555555555555556,0.4248876269826103,0.680826873728043,63,35,0.6363636363636364,0.5087394315103153,0.7513222169426668,66,42,15,25,21,17,20,17,7,7
"wisconsin_exoplanets-llamaphi,wisconsin_exoplanets-openai45,wisconsin_exoplanets-openailong","1,4,4",0.54,0.3932419761169223,0.6818508214313914,50,27,0.43859649122807015,0.3074154334404188,0.576378581253424,57,25,8,13,18,16,19,12,5,16
"wisconsin_exoplanets-anthropic10,wisconsin_exoplanets-deepseek,wisconsin_exoplanets-phi","1,1,1",0.5396825396825397,0.409425527239559,0.6660856620336977,63,34,0.5909090909090909,0.46293656355858825,0.7104508976039902,66,39,11,21,18,16,23,18,11,11
"wisconsin_exoplanets-anthropic10,wisconsin_exoplanets-falcon,wisconsin_exoplanets-gemini","1,1,7",0.5396825396825397,0.409425527239559,0.6660856620336977,63,34,0.6212121212121212,0.4933571772023376,0.7378154230046878,66,41,10,18,17,11,24,23,12,14
"wisconsin_exoplanets-deepseek,wisconsin_exoplanets-phi,wisconsin_exoplanets-qwq","1,1,1",0.5396825396825397,0.409425527239559,0.6660856620336977,63,34,0.5303030303030303,0.403420053441725,0.654378697236779,66,35,9,14,16,13,25,21,13,18
"wisconsin_exoplanets-deepseek,wisconsin_exoplanets-llama,wisconsin_exoplanets-openai10","1,2,5",0.5396825396825397,0.409425527239559,0.6660856620336977,63,34,0.5757575757575758,0.4478940377087594,0.6965980669616616,66,38,18,29,25,25,16,9,4,3
"wisconsin_exoplanets-gemma,wisconsin_exoplanets-llama,wisconsin_exoplanets-llamaphi","1,2,1",0.5396825396825397,0.409425527239559,0.6660856620336977,63,34,0.48484848484848486,0.3599107557499768,0.6111897347222226,66,32,17,21,24,23,17,11,5,11
"wisconsin_exoplanets-geminipro10,wisconsin_exoplanets-openai,wisconsin_exoplanets-phi","3,6,1",0.5396825396825397,0.409425527239559,0.6660856620336977,63,34,0.5454545454545454,0.4181368331466126,0.6685606183790747,66,36,13,16,20,14,21,20,9,16
"wisconsin_exoplanets-deepseek,wisconsin_exoplanets-llama,wisconsin_exoplanets-qwq","1,2,1",0.5396825396825397,0.409425527239559,0.6660856620336977,63,34,0.5151515151515151,0.3888102652777774,0.6400892442500232,66,34,11,17,18,17,23,17,11,15
"wisconsin_exoplanets-anthropic,wisconsin_exoplanets-falcon,wisconsin_exoplanets-llamaphi","2,1,1",0.5396825396825397,0.409425527239559,0.6660856620336977,63,34,0.6515151515151515,0.5242397683271001,0.7647080305896783,66,43,18,27,25,18,16,16,4,5
"wisconsin_exoplanets-anthropic10,wisconsin_exoplanets-gemini,wisconsin_exoplanets-openai10o1","1,7,5",0.5396825396825397,0.409425527239559,0.6660856620336977,63,34,0.5454545454545454,0.4181368331466126,0.6685606183790747,66,36,17,22,24,20,17,14,5,10
"wisconsin_exoplanets-deepseek,wisconsin_exoplanets-gemma,wisconsin_exoplanets-openai10o1","1,1,5",0.5396825396825397,0.409425527239559,0.6660856620336977,63,34,0.5757575757575758,0.4478940377087594,0.6965980669616616,66,38,16,24,23,20,18,14,6,8
"wisconsin_exoplanets-deepseek,wisconsin_exoplanets-gemma,wisconsin_exoplanets-openai10","1,1,5",0.5396825396825397,0.409425527239559,0.6660856620336977,63,34,0.5606060606060606,0.43296119670295957,0.6826341362307495,66,37,16,25,23,22,18,12,6,7
"wisconsin_exoplanets-llama,wisconsin_exoplanets-phi,wisconsin_exoplanets-qwq","2,1,1",0.5396825396825397,0.409425527239559,0.6660856620336977,63,34,0.5606060606060606,0.43296119670295957,0.6826341362307495,66,37,11,18,18,15,23,19,11,14
"wisconsin_exoplanets-gemma,wisconsin_exoplanets-llamaphi,wisconsin_exoplanets-qwq","1,1,1",0.5396825396825397,0.409425527239559,0.6660856620336977,63,34,0.42424242424242425,0.30340193303833835,0.5521059622912405,66,28,17,19,24,25,17,9,5,13
"wisconsin_exoplanets-deepseek,wisconsin_exoplanets-gemma,wisconsin_exoplanets-openai","1,1,6",0.5396825396825397,0.409425527239559,0.6660856620336977,63,34,0.5454545454545454,0.4181368331466126,0.6685606183790747,66,36,17,24,24,22,17,12,5,8
"wisconsin_exoplanets-gemma,wisconsin_exoplanets-openai,wisconsin_exoplanets-qwq","1,6,1",0.5396825396825397,0.409425527239559,0.6660856620336977,63,34,0.45454545454545453,0.3314393816209253,0.5818631668533873,66,30,17,20,24,24,17,10,5,12
"wisconsin_exoplanets-deepseek,wisconsin_exoplanets-llama,wisconsin_exoplanets-phi","1,2,1",0.5396825396825397,0.409425527239559,0.6660856620336977,63,34,0.6060606060606061,0.47809031269657515,0.7241907640463761,66,40,13,21,20,15,21,19,9,11
"wisconsin_exoplanets-gemma,wisconsin_exoplanets-openailong,wisconsin_exoplanets-qwq","1,4,1",0.5396825396825397,0.409425527239559,0.6660856620336977,63,34,0.4393939393939394,0.31736586376925047,0.5670388032970404,66,29,17,19,24,24,17,10,5,13
"wisconsin_exoplanets-anthropic,wisconsin_exoplanets-falcon,wisconsin_exoplanets-openai10o1","2,1,5",0.5396825396825397,0.409425527239559,0.6660856620336977,63,34,0.6818181818181818,0.5556078292305275,0.7911016327585585,66,45,18,26,25,15,16,19,4,6
"wisconsin_exoplanets-geminipro,wisconsin_exoplanets-openailong,wisconsin_exoplanets-qwq","2,4,1",0.5396825396825397,0.409425527239559,0.6660856620336977,63,34,0.5,0.37430716945155507,0.6256928305484449,66,33,10,14,17,15,24,19,12,18
"wisconsin_exoplanets-deepseek,wisconsin_exoplanets-openailong,wisconsin_exoplanets-phi","1,4,1",0.5396825396825397,0.409425527239559,0.6660856620336977,63,34,0.5757575757575758,0.4478940377087594,0.6965980669616616,66,38,18,26,25,22,16,12,4,6
"wisconsin_exoplanets-gemma,wisconsin_exoplanets-openai45,wisconsin_exoplanets-qwq","1,4,1",0.5396825396825397,0.409425527239559,0.6660856620336977,63,34,0.4393939393939394,0.31736586376925047,0.5670388032970404,66,29,17,19,24,24,17,10,5,13
"wisconsin_exoplanets-anthropic10,wisconsin_exoplanets-openai45,wisconsin_exoplanets-openai4510","1,4,2",0.5396825396825397,0.409425527239559,0.6660856620336977,63,34,0.6515151515151515,0.5242397683271001,0.7647080305896783,66,43,15,25,22,16,19,18,7,7
"wisconsin_exoplanets-falcon10,wisconsin_exoplanets-llama,wisconsin_exoplanets-openai45","1,2,4",0.5396825396825397,0.409425527239559,0.6660856620336977,63,34,0.5757575757575758,0.4478940377087594,0.6965980669616616,66,38,20,27,27,23,14,11,2,5
"wisconsin_exoplanets-falcon,wisconsin_exoplanets-geminipro10,wisconsin_exoplanets-openai","1,3,6",0.5396825396825397,0.409425527239559,0.6660856620336977,63,34,0.5454545454545454,0.4181368331466126,0.6685606183790747,66,36,14,16,21,14,20,20,8,16
"wisconsin_exoplanets-gemini10,wisconsin_exoplanets-openailong,wisconsin_exoplanets-phi","2,4,1",0.5396825396825397,0.409425527239559,0.6660856620336977,63,34,0.6515151515151515,0.5242397683271001,0.7647080305896783,66,43,13,21,20,12,21,22,9,11
"wisconsin_exoplanets-falcon,wisconsin_exoplanets-gemini,wisconsin_exoplanets-openailong","1,7,4",0.5396825396825397,0.409425527239559,0.6660856620336977,63,34,0.6060606060606061,0.47809031269657515,0.7241907640463761,66,40,19,26,26,20,15,14,3,6
"wisconsin_exoplanets-falcon,wisconsin_exoplanets-gemini,wisconsin_exoplanets-openai45","1,7,4",0.5396825396825397,0.409425527239559,0.6660856620336977,63,34,0.6060606060606061,0.47809031269657515,0.7241907640463761,66,40,19,26,26,20,15,14,3,6
"wisconsin_exoplanets-anthropic10,wisconsin_exoplanets-geminipro10,wisconsin_exoplanets-qwq","1,3,1",0.5396825396825397,0.409425527239559,0.6660856620336977,63,34,0.4696969696969697,0.345621302763221,0.5965799465582751,66,31,5,9,12,12,29,22,17,23
"wisconsin_exoplanets-gemini10,wisconsin_exoplanets-openai45,wisconsin_exoplanets-qwq","2,4,1",0.5396825396825397,0.409425527239559,0.6660856620336977,63,34,0.5757575757575758,0.4478940377087594,0.6965980669616616,66,38,10,17,17,13,24,21,12,15
"wisconsin_exoplanets-falcon10,wisconsin_exoplanets-gemma,wisconsin_exoplanets-openai","1,1,6",0.5396825396825397,0.409425527239559,0.6660856620336977,63,34,0.5,0.37430716945155507,0.6256928305484449,66,33,17,23,24,24,17,10,5,9
"wisconsin_exoplanets-deepseek,wisconsin_exoplanets-falcon10,wisconsin_exoplanets-openai45","1,1,4",0.5396825396825397,0.409425527239559,0.6660856620336977,63,34,0.6060606060606061,0.47809031269657515,0.7241907640463761,66,40,18,28,25,22,16,12,4,4
"wisconsin_exoplanets-falcon10,wisconsin_exoplanets-gemma,wisconsin_exoplanets-llamaphi","1,1,1",0.5396825396825397,0.409425527239559,0.6660856620336977,63,34,0.5,0.37430716945155507,0.6256928305484449,66,33,17,23,24,24,17,10,5,9
"wisconsin_exoplanets-anthropic10,wisconsin_exoplanets-openai10,wisconsin_exoplanets-openai4510","1,5,2",0.5396825396825397,0.409425527239559,0.6660856620336977,63,34,0.6363636363636364,0.5087394315103153,0.7513222169426668,66,42,15,25,22,17,19,17,7,7
"wisconsin_exoplanets-falcon10,wisconsin_exoplanets-geminipro10,wisconsin_exoplanets-openai10o1","1,3,5",0.5396825396825397,0.409425527239559,0.6660856620336977,63,34,0.6666666666666666,0.5398613431497497,0.7779692372780057,66,44,13,23,20,13,21,21,9,9
"wisconsin_exoplanets-falcon10,wisconsin_exoplanets-geminipro10,wisconsin_exoplanets-openai10","1,3,5",0.5396825396825397,0.409425527239559,0.6660856620336977,63,34,0.6212121212121212,0.4933571772023376,0.7378154230046878,66,41,13,23,20,16,21,18,9,9
"wisconsin_exoplanets-gemini10,wisconsin_exoplanets-openai45,wisconsin_exoplanets-phi","2,4,1",0.5396825396825397,0.409425527239559,0.6660856620336977,63,34,0.6666666666666666,0.5398613431497497,0.7779692372780057,66,44,14,21,21,11,20,23,8,11
"wisconsin_exoplanets-deepseek,wisconsin_exoplanets-falcon,wisconsin_exoplanets-llama","1,1,2",0.5396825396825397,0.409425527239559,0.6660856620336977,63,34,0.5757575757575758,0.4478940377087594,0.6965980669616616,66,38,13,18,20,14,21,20,9,14
"wisconsin_exoplanets-falcon10,wisconsin_exoplanets-llama,wisconsin_exoplanets-openailong","1,2,4",0.5396825396825397,0.409425527239559,0.6660856620336977,63,34,0.5757575757575758,0.4478940377087594,0.6965980669616616,66,38,20,27,27,23,14,11,2,5
"wisconsin_exoplanets-falcon,wisconsin_exoplanets-gemini,wisconsin_exoplanets-phi","1,7,1",0.5396825396825397,0.409425527239559,0.6660856620336977,63,34,0.5606060606060606,0.43296119670295957,0.6826341362307495,66,37,12,12,19,9,22,25,10,20
"wisconsin_exoplanets-falcon10,wisconsin_exoplanets-openai10,wisconsin_exoplanets-openai10o1","1,5,5",0.5396825396825397,0.409425527239559,0.6660856620336977,63,34,0.5606060606060606,0.43296119670295957,0.6826341362307495,66,37,12,21,19,18,22,16,10,11
"wisconsin_exoplanets-falcon10,wisconsin_exoplanets-llamaphi,wisconsin_exoplanets-openai45","1,1,4",0.5396825396825397,0.409425527239559,0.6660856620336977,63,34,0.5606060606060606,0.43296119670295957,0.6826341362307495,66,37,14,21,21,18,20,16,8,11
"wisconsin_exoplanets-falcon,wisconsin_exoplanets-gemini,wisconsin_exoplanets-llamaphi","1,7,1",0.5396825396825397,0.409425527239559,0.6660856620336977,63,34,0.6212121212121212,0.4933571772023376,0.7378154230046878,66,41,18,25,25,18,16,16,4,7
"wisconsin_exoplanets-geminipro,wisconsin_exoplanets-llamaphi,wisconsin_exoplanets-phi","2,1,1",0.5396825396825397,0.409425527239559,0.6660856620336977,63,34,0.5,0.37430716945155507,0.6256928305484449,66,33,13,14,20,15,21,19,9,18
"wisconsin_exoplanets-deepseek,wisconsin_exoplanets-falcon10,wisconsin_exoplanets-openai10","1,1,5",0.5396825396825397,0.409425527239559,0.6660856620336977,63,34,0.5909090909090909,0.46293656355858825,0.7104508976039902,66,39,18,28,25,23,16,11,4,4
"wisconsin_exoplanets-falcon10,wisconsin_exoplanets-openai10o1,wisconsin_exoplanets-openai45","1,5,4",0.5396825396825397,0.409425527239559,0.6660856620336977,63,34,0.5606060606060606,0.43296119670295957,0.6826341362307495,66,37,13,21,20,18,21,16,9,11
"wisconsin_exoplanets-deepseek,wisconsin_exoplanets-falcon10,wisconsin_exoplanets-openailong","1,1,4",0.5396825396825397,0.409425527239559,0.6660856620336977,63,34,0.5909090909090909,0.46293656355858825,0.7104508976039902,66,39,18,28,25,23,16,11,4,4
"wisconsin_exoplanets-geminipro10,wisconsin_exoplanets-llamaphi,wisconsin_exoplanets-phi","3,1,1",0.5238095238095238,0.39408375507846266,0.6512232887337103,63,33,0.5303030303030303,0.403420053441725,0.654378697236779,66,35,13,16,21,15,20,19,9,16
"wisconsin_exoplanets-falcon10,wisconsin_exoplanets-phi,wisconsin_exoplanets-qwq","1,1,1",0.5238095238095238,0.39408375507846266,0.6512232887337103,63,33,0.5,0.37430716945155507,0.6256928305484449,66,33,11,16,19,17,22,17,11,16
"wisconsin_exoplanets-geminipro10,wisconsin_exoplanets-openai10,wisconsin_exoplanets-qwq","3,5,1",0.5238095238095238,0.39408375507846266,0.6512232887337103,63,33,0.5,0.37430716945155507,0.6256928305484449,66,33,11,14,19,15,22,19,11,18
"wisconsin_exoplanets-geminipro10,wisconsin_exoplanets-openai10o1,wisconsin_exoplanets-qwq","3,5,1",0.5238095238095238,0.39408375507846266,0.6512232887337103,63,33,0.48484848484848486,0.3599107557499768,0.6111897347222226,66,32,12,12,20,14,21,20,10,20
"wisconsin_exoplanets-deepseek,wisconsin_exoplanets-gemma,wisconsin_exoplanets-llamaphi","1,1,1",0.5238095238095238,0.39408375507846266,0.6512232887337103,63,33,0.5454545454545454,0.4181368331466126,0.6685606183790747,66,36,16,25,24,23,17,11,6,7
"wisconsin_exoplanets-deepseek,wisconsin_exoplanets-openai,wisconsin_exoplanets-phi","1,6,1",0.5238095238095238,0.39408375507846266,0.6512232887337103,63,33,0.5757575757575758,0.4478940377087594,0.6965980669616616,66,38,18,26,26,22,15,12,4,6
"wisconsin_exoplanets-gemini10,wisconsin_exoplanets-openai10,wisconsin_exoplanets-phi","2,5,1",0.5238095238095238,0.39408375507846266,0.6512232887337103,63,33,0.6515151515151515,0.5242397683271001,0.7647080305896783,66,43,12,21,20,12,21,22,10,11
"wisconsin_exoplanets-falcon10,wisconsin_exoplanets-llama,wisconsin_exoplanets-qwq","1,2,1",0.5238095238095238,0.39408375507846266,0.6512232887337103,63,33,0.5303030303030303,0.403420053441725,0.654378697236779,66,35,12,15,20,14,21,20,10,17
"wisconsin_exoplanets-deepseek,wisconsin_exoplanets-openai45,wisconsin_exoplanets-phi","1,4,1",0.5238095238095238,0.39408375507846266,0.6512232887337103,63,33,0.5909090909090909,0.46293656355858825,0.7104508976039902,66,39,18,26,26,21,15,13,4,6
"wisconsin_exoplanets-anthropic10,wisconsin_exoplanets-falcon,wisconsin_exoplanets-openai4510","1,1,2",0.5238095238095238,0.39408375507846266,0.6512232887337103,63,33,0.5454545454545454,0.4181368331466126,0.6685606183790747,66,36,6,12,14,10,27,24,16,20
"wisconsin_exoplanets-anthropic10,wisconsin_exoplanets-llama,wisconsin_exoplanets-qwq","1,2,1",0.5238095238095238,0.39408375507846266,0.6512232887337103,63,33,0.5,0.37430716945155507,0.6256928305484449,66,33,9,16,17,17,24,17,13,16
"wisconsin_exoplanets-falcon10,wisconsin_exoplanets-llama,wisconsin_exoplanets-openai10","1,2,5",0.5238095238095238,0.39408375507846266,0.6512232887337103,63,33,0.5909090909090909,0.46293656355858825,0.7104508976039902,66,39,20,28,28,23,13,11,2,4
"wisconsin_exoplanets-falcon10,wisconsin_exoplanets-llama,wisconsin_exoplanets-openai10o1","1,2,5",0.5238095238095238,0.39408375507846266,0.6512232887337103,63,33,0.5909090909090909,0.46293656355858825,0.7104508976039902,66,39,19,26,27,21,14,13,3,6
"wisconsin_exoplanets-anthropic10,wisconsin_exoplanets-llama,wisconsin_exoplanets-phi","1,2,1",0.5238095238095238,0.39408375507846266,0.6512232887337103,63,33,0.5606060606060606,0.43296119670295957,0.6826341362307495,66,37,11,20,19,17,22,17,11,12
"wisconsin_exoplanets-gemini10,wisconsin_exoplanets-openai10o1,wisconsin_exoplanets-phi","2,5,1",0.5238095238095238,0.39408375507846266,0.6512232887337103,63,33,0.6363636363636364,0.5087394315103153,0.7513222169426668,66,42,13,21,21,13,20,21,9,11
"wisconsin_exoplanets-gemini10,wisconsin_exoplanets-openailong,wisconsin_exoplanets-qwq","2,4,1",0.5238095238095238,0.39408375507846266,0.6512232887337103,63,33,0.5606060606060606,0.43296119670295957,0.6826341362307495,66,37,9,17,17,14,24,20,13,15
"wisconsin_exoplanets-deepseek,wisconsin_exoplanets-falcon10,wisconsin_exoplanets-openai10o1","1,1,5",0.5238095238095238,0.39408375507846266,0.6512232887337103,63,33,0.6060606060606061,0.47809031269657515,0.7241907640463761,66,40,17,28,25,22,16,12,5,4
"wisconsin_exoplanets-anthropic10,wisconsin_exoplanets-falcon,wisconsin_exoplanets-geminipro10","1,1,3",0.5238095238095238,0.39408375507846266,0.6512232887337103,63,33,0.5151515151515151,0.3888102652777774,0.6400892442500232,66,34,6,11,14,11,27,23,16,21
"wisconsin_exoplanets-anthropic10,wisconsin_exoplanets-gemini,wisconsin_exoplanets-openai45","1,7,4",0.5238095238095238,0.39408375507846266,0.6512232887337103,63,33,0.5454545454545454,0.4181368331466126,0.6685606183790747,66,36,17,23,25,21,16,13,5,9
"wisconsin_exoplanets-llama,wisconsin_exoplanets-openai10o1,wisconsin_exoplanets-qwq","2,5,1",0.5238095238095238,0.39408375507846266,0.6512232887337103,63,33,0.5757575757575758,0.4478940377087594,0.6965980669616616,66,38,16,24,24,20,17,14,6,8
"wisconsin_exoplanets-anthropic10,wisconsin_exoplanets-gemini,wisconsin_exoplanets-openailong","1,7,4",0.5238095238095238,0.39408375507846266,0.6512232887337103,63,33,0.5303030303030303,0.403420053441725,0.654378697236779,66,35,16,23,24,22,17,12,6,9
"wisconsin_exoplanets-falcon,wisconsin_exoplanets-geminipro10,wisconsin_exoplanets-llamaphi","1,3,1",0.5238095238095238,0.39408375507846266,0.6512232887337103,63,33,0.5151515151515151,0.3888102652777774,0.6400892442500232,66,34,14,15,22,15,19,19,8,17
"wisconsin_exoplanets-anthropic10,wisconsin_exoplanets-geminipro10,wisconsin_exoplanets-openai","1,3,6",0.5238095238095238,0.39408375507846266,0.6512232887337103,63,33,0.5303030303030303,0.403420053441725,0.654378697236779,66,35,12,19,20,18,21,16,10,13
"wisconsin_exoplanets-anthropic10,wisconsin_exoplanets-openai10o1,wisconsin_exoplanets-openai4510","1,5,2",0.5238095238095238,0.39408375507846266,0.6512232887337103,63,33,0.6212121212121212,0.4933571772023376,0.7378154230046878,66,41,14,23,22,16,19,18,8,9
"wisconsin_exoplanets-gemma,wisconsin_exoplanets-openai10o1,wisconsin_exoplanets-qwq","1,5,1",0.5238095238095238,0.39408375507846266,0.6512232887337103,63,33,0.48484848484848486,0.3599107557499768,0.6111897347222226,66,32,16,19,24,21,17,13,6,13
"wisconsin_exoplanets-anthropic10,wisconsin_exoplanets-deepseek,wisconsin_exoplanets-falcon","1,1,1",0.5238095238095238,0.39408375507846266,0.6512232887337103,63,33,0.5303030303030303,0.403420053441725,0.654378697236779,66,35,10,17,18,16,23,18,12,15
"wisconsin_exoplanets-falcon,wisconsin_exoplanets-geminipro10,wisconsin_exoplanets-openai45","1,3,4",0.5238095238095238,0.39408375507846266,0.6512232887337103,63,33,0.5303030303030303,0.403420053441725,0.654378697236779,66,35,14,16,22,15,19,19,8,16
"wisconsin_exoplanets-anthropic10,wisconsin_exoplanets-falcon10,wisconsin_exoplanets-qwq","1,1,1",0.5238095238095238,0.39408375507846266,0.6512232887337103,63,33,0.5151515151515151,0.3888102652777774,0.6400892442500232,66,34,9,17,17,17,24,17,13,15
"wisconsin_exoplanets-llama,wisconsin_exoplanets-openai,wisconsin_exoplanets-qwq","2,6,1",0.5238095238095238,0.39408375507846266,0.6512232887337103,63,33,0.5151515151515151,0.3888102652777774,0.6400892442500232,66,34,16,22,24,22,17,12,6,10
"wisconsin_exoplanets-deepseek,wisconsin_exoplanets-openai,wisconsin_exoplanets-qwq","1,6,1",0.5238095238095238,0.39408375507846266,0.6512232887337103,63,33,0.5606060606060606,0.43296119670295957,0.6826341362307495,66,37,15,23,23,20,18,14,7,9
"wisconsin_exoplanets-gemini,wisconsin_exoplanets-openai,wisconsin_exoplanets-phi","7,6,1",0.5238095238095238,0.39408375507846266,0.6512232887337103,63,33,0.5303030303030303,0.403420053441725,0.654378697236779,66,35,17,21,25,20,16,14,5,11
"wisconsin_exoplanets-falcon,wisconsin_exoplanets-gemini10,wisconsin_exoplanets-phi","1,2,1",0.5238095238095238,0.39408375507846266,0.6512232887337103,63,33,0.6060606060606061,0.47809031269657515,0.7241907640463761,66,40,7,12,15,6,26,28,15,20
"wisconsin_exoplanets-falcon,wisconsin_exoplanets-openai10o1,wisconsin_exoplanets-openaio1","1,5,2",0.5238095238095238,0.39408375507846266,0.6512232887337103,63,33,0.6212121212121212,0.4933571772023376,0.7378154230046878,66,41,18,21,26,14,15,20,4,11
"wisconsin_exoplanets-falcon,wisconsin_exoplanets-geminipro10,wisconsin_exoplanets-phi","1,3,1",0.5238095238095238,0.39408375507846266,0.6512232887337103,63,33,0.5757575757575758,0.4478940377087594,0.6965980669616616,66,38,9,10,17,6,24,28,13,22
"wisconsin_exoplanets-deepseek,wisconsin_exoplanets-openai10,wisconsin_exoplanets-phi","1,5,1",0.5238095238095238,0.39408375507846266,0.6512232887337103,63,33,0.5909090909090909,0.46293656355858825,0.7104508976039902,66,39,18,27,26,22,15,12,4,5
"wisconsin_exoplanets-anthropic10,wisconsin_exoplanets-gemini10,wisconsin_exoplanets-openai","1,2,6",0.5238095238095238,0.39408375507846266,0.6512232887337103,63,33,0.5303030303030303,0.403420053441725,0.654378697236779,66,35,11,19,19,18,22,16,11,13
"wisconsin_exoplanets-anthropic10,wisconsin_exoplanets-geminipro10,wisconsin_exoplanets-llamaphi","1,3,1",0.5238095238095238,0.39408375507846266,0.6512232887337103,63,33,0.5151515151515151,0.3888102652777774,0.6400892442500232,66,34,12,20,20,20,21,14,10,12
"wisconsin_exoplanets-anthropic10,wisconsin_exoplanets-deepseek,wisconsin_exoplanets-falcon10","1,1,1",0.5238095238095238,0.39408375507846266,0.6512232887337103,63,33,0.5151515151515151,0.3888102652777774,0.6400892442500232,66,34,13,17,21,17,20,17,9,15
"wisconsin_exoplanets-anthropic10,wisconsin_exoplanets-deepseek,wisconsin_exoplanets-openailong","1,1,4",0.5079365079365079,0.37886176274011957,0.6362406400008651,63,32,0.5,0.37430716945155507,0.6256928305484449,66,33,17,25,26,26,15,8,5,7
"wisconsin_exoplanets-deepseek,wisconsin_exoplanets-llamaphi,wisconsin_exoplanets-qwq","1,1,1",0.5079365079365079,0.37886176274011957,0.6362406400008651,63,32,0.5303030303030303,0.403420053441725,0.654378697236779,66,35,14,23,23,22,18,12,8,9
"wisconsin_exoplanets-falcon,wisconsin_exoplanets-geminipro,wisconsin_exoplanets-phi","1,2,1",0.5079365079365079,0.37886176274011957,0.6362406400008651,63,32,0.5606060606060606,0.43296119670295957,0.6826341362307495,66,37,6,9,15,6,26,28,16,23
"wisconsin_exoplanets-anthropic10,wisconsin_exoplanets-falcon,wisconsin_exoplanets-geminipro","1,1,2",0.5079365079365079,0.37886176274011957,0.6362406400008651,63,32,0.48484848484848486,0.3599107557499768,0.6111897347222226,66,32,5,9,14,11,27,23,17,23
"wisconsin_exoplanets-anthropic10,wisconsin_exoplanets-deepseek,wisconsin_exoplanets-openai45","1,1,4",0.5079365079365079,0.37886176274011957,0.6362406400008651,63,32,0.5151515151515151,0.3888102652777774,0.6400892442500232,66,34,18,25,27,25,14,9,4,7
"wisconsin_exoplanets-anthropic10,wisconsin_exoplanets-deepseek,wisconsin_exoplanets-openai10","1,1,5",0.5079365079365079,0.37886176274011957,0.6362406400008651,63,32,0.5151515151515151,0.3888102652777774,0.6400892442500232,66,34,17,26,26,26,15,8,5,6
"wisconsin_exoplanets-deepseek,wisconsin_exoplanets-openai10o1,wisconsin_exoplanets-phi","1,5,1",0.5079365079365079,0.37886176274011957,0.6362406400008651,63,32,0.6363636363636364,0.5087394315103153,0.7513222169426668,66,42,18,27,27,19,14,15,4,5
"wisconsin_exoplanets-llama,wisconsin_exoplanets-openai45,wisconsin_exoplanets-qwq","2,4,1",0.5079365079365079,0.37886176274011957,0.6362406400008651,63,32,0.5454545454545454,0.4181368331466126,0.6685606183790747,66,36,16,24,25,22,16,12,6,8
"wisconsin_exoplanets-gemma,wisconsin_exoplanets-openai10,wisconsin_exoplanets-qwq","1,5,1",0.5079365079365079,0.37886176274011957,0.6362406400008651,63,32,0.45454545454545453,0.3314393816209253,0.5818631668533873,66,30,16,20,25,24,16,10,6,12
"wisconsin_exoplanets-falcon,wisconsin_exoplanets-geminipro10,wisconsin_exoplanets-openailong","1,3,4",0.5079365079365079,0.37886176274011957,0.6362406400008651,63,32,0.5303030303030303,0.403420053441725,0.654378697236779,66,35,13,16,22,15,19,19,9,16
"wisconsin_exoplanets-anthropic10,wisconsin_exoplanets-llamaphi,wisconsin_exoplanets-openai","1,1,6",0.5079365079365079,0.37886176274011957,0.6362406400008651,63,32,0.48484848484848486,0.3599107557499768,0.6111897347222226,66,32,10,18,19,20,22,14,12,14
"wisconsin_exoplanets-falcon,wisconsin_exoplanets-gemini,wisconsin_exoplanets-openai10","1,7,5",0.5079365079365079,0.37886176274011957,0.6362406400008651,63,32,0.6060606060606061,0.47809031269657515,0.7241907640463761,66,40,18,26,27,20,14,14,4,6
"wisconsin_exoplanets-llama,wisconsin_exoplanets-openailong,wisconsin_exoplanets-qwq","2,4,1",0.5079365079365079,0.37886176274011957,0.6362406400008651,63,32,0.5454545454545454,0.4181368331466126,0.6685606183790747,66,36,16,24,25,22,16,12,6,8
"wisconsin_exoplanets-falcon,wisconsin_exoplanets-geminipro10,wisconsin_exoplanets-qwq","1,3,1",0.5079365079365079,0.37886176274011957,0.6362406400008651,63,32,0.5151515151515151,0.3888102652777774,0.6400892442500232,66,34,5,8,14,8,27,26,17,24
"wisconsin_exoplanets-falcon,wisconsin_exoplanets-gemini,wisconsin_exoplanets-openai10o1","1,7,5",0.5079365079365079,0.37886176274011957,0.6362406400008651,63,32,0.6515151515151515,0.5242397683271001,0.7647080305896783,66,43,17,25,26,16,15,18,5,7
"wisconsin_exoplanets-deepseek,wisconsin_exoplanets-openai10o1,wisconsin_exoplanets-qwq","1,5,1",0.5079365079365079,0.37886176274011957,0.6362406400008651,63,32,0.5606060606060606,0.43296119670295957,0.6826341362307495,66,37,15,22,24,19,17,15,7,10
"wisconsin_exoplanets-falcon,wisconsin_exoplanets-falcon10,wisconsin_exoplanets-gemma","1,1,1",0.5079365079365079,0.37886176274011957,0.6362406400008651,63,32,0.5,0.37430716945155507,0.6256928305484449,66,33,11,14,20,15,21,19,11,18
"wisconsin_exoplanets-anthropic10,wisconsin_exoplanets-falcon,wisconsin_exoplanets-gemini10","1,1,2",0.5079365079365079,0.37886176274011957,0.6362406400008651,63,32,0.5303030303030303,0.403420053441725,0.654378697236779,66,35,4,11,13,10,28,24,18,21
"wisconsin_exoplanets-anthropic10,wisconsin_exoplanets-gemini10,wisconsin_exoplanets-llamaphi","1,2,1",0.5079365079365079,0.37886176274011957,0.6362406400008651,63,32,0.5,0.37430716945155507,0.6256928305484449,66,33,10,19,19,20,22,14,12,13
"wisconsin_exoplanets-anthropic10,wisconsin_exoplanets-gemini,wisconsin_exoplanets-openai10","1,7,5",0.5079365079365079,0.37886176274011957,0.6362406400008651,63,32,0.5303030303030303,0.403420053441725,0.654378697236779,66,35,16,23,25,22,16,12,6,9
"wisconsin_exoplanets-falcon10,wisconsin_exoplanets-gemma,wisconsin_exoplanets-openailong","1,1,4",0.5079365079365079,0.37886176274011957,0.6362406400008651,63,32,0.5454545454545454,0.4181368331466126,0.6685606183790747,66,36,17,25,26,23,15,11,5,7
"wisconsin_exoplanets-anthropic10,wisconsin_exoplanets-geminipro,wisconsin_exoplanets-openai","1,2,6",0.5079365079365079,0.37886176274011957,0.6362406400008651,63,32,0.5151515151515151,0.3888102652777774,0.6400892442500232,66,34,10,18,19,18,22,16,12,14
"wisconsin_exoplanets-geminipro,wisconsin_exoplanets-openailong,wisconsin_exoplanets-phi","2,4,1",0.5079365079365079,0.37886176274011957,0.6362406400008651,63,32,0.5454545454545454,0.4181368331466126,0.6685606183790747,66,36,12,15,21,13,20,21,10,17
"wisconsin_exoplanets-anthropic10,wisconsin_exoplanets-falcon10,wisconsin_exoplanets-phi","1,1,1",0.5079365079365079,0.37886176274011957,0.6362406400008651,63,32,0.5454545454545454,0.4181368331466126,0.6685606183790747,66,36,13,19,22,17,19,17,9,13
"wisconsin_exoplanets-anthropic10,wisconsin_exoplanets-geminipro10,wisconsin_exoplanets-openailong","1,3,4",0.5079365079365079,0.37886176274011957,0.6362406400008651,63,32,0.5606060606060606,0.43296119670295957,0.6826341362307495,66,37,12,20,21,17,20,17,10,12
"wisconsin_exoplanets-anthropic10,wisconsin_exoplanets-geminipro,wisconsin_exoplanets-llamaphi","1,2,1",0.5079365079365079,0.37886176274011957,0.6362406400008651,63,32,0.5,0.37430716945155507,0.6256928305484449,66,33,10,19,19,20,22,14,12,13
"wisconsin_exoplanets-anthropic10,wisconsin_exoplanets-falcon10,wisconsin_exoplanets-openai","1,1,6",0.5079365079365079,0.37886176274011957,0.6362406400008651,63,32,0.5151515151515151,0.3888102652777774,0.6400892442500232,66,34,17,25,26,25,15,9,5,7
"wisconsin_exoplanets-geminipro,wisconsin_exoplanets-openai45,wisconsin_exoplanets-phi","2,4,1",0.5079365079365079,0.37886176274011957,0.6362406400008651,63,32,0.5606060606060606,0.43296119670295957,0.6826341362307495,66,37,13,15,22,12,19,22,9,17
"wisconsin_exoplanets-falcon10,wisconsin_exoplanets-gemma,wisconsin_exoplanets-openai45","1,1,4",0.5079365079365079,0.37886176274011957,0.6362406400008651,63,32,0.5454545454545454,0.4181368331466126,0.6685606183790747,66,36,17,25,26,23,15,11,5,7
"wisconsin_exoplanets-falcon,wisconsin_exoplanets-openai,wisconsin_exoplanets-openai4510","1,6,2",0.5079365079365079,0.37886176274011957,0.6362406400008651,63,32,0.5757575757575758,0.4478940377087594,0.6965980669616616,66,38,13,17,22,13,19,21,9,15
"wisconsin_exoplanets-deepseek,wisconsin_exoplanets-llamaphi,wisconsin_exoplanets-phi","1,1,1",0.5079365079365079,0.37886176274011957,0.6362406400008651,63,32,0.5757575757575758,0.4478940377087594,0.6965980669616616,66,38,18,27,27,23,14,11,4,5
"wisconsin_exoplanets-falcon,wisconsin_exoplanets-openai45,wisconsin_exoplanets-openai4510","1,4,2",0.5079365079365079,0.37886176274011957,0.6362406400008651,63,32,0.5757575757575758,0.4478940377087594,0.6965980669616616,66,38,13,18,22,14,19,20,9,14
"wisconsin_exoplanets-geminipro,wisconsin_exoplanets-openai10,wisconsin_exoplanets-qwq","2,5,1",0.5079365079365079,0.37886176274011957,0.6362406400008651,63,32,0.5,0.37430716945155507,0.6256928305484449,66,33,9,14,18,15,23,19,13,18
"wisconsin_exoplanets-falcon10,wisconsin_exoplanets-openai,wisconsin_exoplanets-phi","1,6,1",0.5079365079365079,0.37886176274011957,0.6362406400008651,63,32,0.5757575757575758,0.4478940377087594,0.6965980669616616,66,38,17,26,26,22,15,12,5,6
"wisconsin_exoplanets-anthropic10,wisconsin_exoplanets-gemini10,wisconsin_exoplanets-openailong","1,2,4",0.5079365079365079,0.37886176274011957,0.6362406400008651,63,32,0.5606060606060606,0.43296119670295957,0.6826341362307495,66,37,11,20,20,17,21,17,11,12
"wisconsin_exoplanets-falcon,wisconsin_exoplanets-falcon10,wisconsin_exoplanets-llama","1,1,2",0.5079365079365079,0.37886176274011957,0.6362406400008651,63,32,0.5606060606060606,0.43296119670295957,0.6826341362307495,66,37,11,19,20,16,21,18,11,13
"wisconsin_exoplanets-llamaphi,wisconsin_exoplanets-openai4510,wisconsin_exoplanets-openailong","1,2,4",0.5,0.3552729971299086,0.6447270028700913,50,25,0.47368421052631576,0.339848322631531,0.6103478223726841,57,27,9,15,21,16,16,12,4,14
"wisconsin_exoplanets-llamaphi,wisconsin_exoplanets-openai10,wisconsin_exoplanets-openailong","1,5,4",0.5,0.3552729971299086,0.6447270028700913,50,25,0.45614035087719296,0.3235541763724248,0.5934402539954737,57,26,7,13,19,15,18,13,6,16
"wisconsin_exoplanets-llamaphi,wisconsin_exoplanets-openai10,wisconsin_exoplanets-openai45","1,5,4",0.5,0.3552729971299086,0.6447270028700913,50,25,0.43859649122807015,0.3074154334404188,0.576378581253424,57,25,7,13,19,16,18,12,6,16
"wisconsin_exoplanets-llamaphi,wisconsin_exoplanets-openai45,wisconsin_exoplanets-openai4510","1,4,2",0.5,0.3552729971299086,0.6447270028700913,50,25,0.47368421052631576,0.339848322631531,0.6103478223726841,57,27,9,15,21,16,16,12,4,14
"wisconsin_exoplanets-llamaphi,wisconsin_exoplanets-openaio1,wisconsin_exoplanets-qwq","1,2,1",0.5,0.3552729971299086,0.6447270028700913,50,25,0.40350877192982454,0.2756127242679726,0.5417865985973231,57,23,8,11,20,16,17,12,5,18
"wisconsin_exoplanets-gemma,wisconsin_exoplanets-openai,wisconsin_exoplanets-phi","1,6,1",0.49206349206349204,0.36375935999913483,0.6211382372598804,63,31,0.5151515151515151,0.3888102652777774,0.6400892442500232,66,34,17,20,27,20,14,14,5,12
"wisconsin_exoplanets-anthropic10,wisconsin_exoplanets-gemini10,wisconsin_exoplanets-openai45","1,2,4",0.49206349206349204,0.36375935999913483,0.6211382372598804,63,31,0.5757575757575758,0.4478940377087594,0.6965980669616616,66,38,11,20,21,16,20,18,11,12
"wisconsin_exoplanets-llama,wisconsin_exoplanets-openailong,wisconsin_exoplanets-phi","2,4,1",0.49206349206349204,0.36375935999913483,0.6211382372598804,63,31,0.5606060606060606,0.43296119670295957,0.6826341362307495,66,37,17,27,27,24,14,10,5,5
"wisconsin_exoplanets-anthropic10,wisconsin_exoplanets-falcon10,wisconsin_exoplanets-openailong","1,1,4",0.49206349206349204,0.36375935999913483,0.6211382372598804,63,31,0.48484848484848486,0.3599107557499768,0.6111897347222226,66,32,16,24,26,26,15,8,6,8
"wisconsin_exoplanets-gemini,wisconsin_exoplanets-llamaphi,wisconsin_exoplanets-phi","7,1,1",0.49206349206349204,0.36375935999913483,0.6211382372598804,63,31,0.5303030303030303,0.403420053441725,0.654378697236779,66,35,16,22,26,21,15,13,6,10
"wisconsin_exoplanets-deepseek,wisconsin_exoplanets-openai10,wisconsin_exoplanets-qwq","1,5,1",0.49206349206349204,0.36375935999913483,0.6211382372598804,63,31,0.5454545454545454,0.4181368331466126,0.6685606183790747,66,36,15,24,25,22,16,12,7,8
"wisconsin_exoplanets-falcon,wisconsin_exoplanets-geminipro,wisconsin_exoplanets-qwq","1,2,1",0.49206349206349204,0.36375935999913483,0.6211382372598804,63,31,0.5,0.37430716945155507,0.6256928305484449,66,33,4,7,14,8,27,26,18,25
"wisconsin_exoplanets-deepseek,wisconsin_exoplanets-openailong,wisconsin_exoplanets-qwq","1,4,1",0.49206349206349204,0.36375935999913483,0.6211382372598804,63,31,0.5303030303030303,0.403420053441725,0.654378697236779,66,35,15,23,25,22,16,12,7,9
"wisconsin_exoplanets-llama,wisconsin_exoplanets-openai10,wisconsin_exoplanets-phi","2,5,1",0.49206349206349204,0.36375935999913483,0.6211382372598804,63,31,0.5606060606060606,0.43296119670295957,0.6826341362307495,66,37,17,27,27,24,14,10,5,5
"wisconsin_exoplanets-deepseek,wisconsin_exoplanets-falcon,wisconsin_exoplanets-gemma","1,1,1",0.49206349206349204,0.36375935999913483,0.6211382372598804,63,31,0.5151515151515151,0.3888102652777774,0.6400892442500232,66,34,11,14,21,14,20,20,11,18
"wisconsin_exoplanets-falcon,wisconsin_exoplanets-gemini10,wisconsin_exoplanets-openai","1,2,6",0.49206349206349204,0.36375935999913483,0.6211382372598804,63,31,0.5909090909090909,0.46293656355858825,0.7104508976039902,66,39,11,18,21,13,20,21,11,14
"wisconsin_exoplanets-llama,wisconsin_exoplanets-openai10,wisconsin_exoplanets-qwq","2,5,1",0.49206349206349204,0.36375935999913483,0.6211382372598804,63,31,0.5454545454545454,0.4181368331466126,0.6685606183790747,66,36,16,24,26,22,15,12,6,8
"wisconsin_exoplanets-falcon,wisconsin_exoplanets-geminipro10,wisconsin_exoplanets-openai10","1,3,5",0.49206349206349204,0.36375935999913483,0.6211382372598804,63,31,0.5303030303030303,0.403420053441725,0.654378697236779,66,35,13,16,23,15,18,19,9,16
"wisconsin_exoplanets-geminipro,wisconsin_exoplanets-openai10,wisconsin_exoplanets-phi","2,5,1",0.49206349206349204,0.36375935999913483,0.6211382372598804,63,31,0.5454545454545454,0.4181368331466126,0.6685606183790747,66,36,11,15,21,13,20,21,11,17
"wisconsin_exoplanets-geminipro,wisconsin_exoplanets-openai10o1,wisconsin_exoplanets-qwq","2,5,1",0.49206349206349204,0.36375935999913483,0.6211382372598804,63,31,0.48484848484848486,0.3599107557499768,0.6111897347222226,66,32,9,12,19,14,22,20,13,20
"wisconsin_exoplanets-llama,wisconsin_exoplanets-openai10o1,wisconsin_exoplanets-phi","2,5,1",0.49206349206349204,0.36375935999913483,0.6211382372598804,63,31,0.5606060606060606,0.43296119670295957,0.6826341362307495,66,37,17,25,27,22,14,12,5,7
"wisconsin_exoplanets-falcon,wisconsin_exoplanets-openai4510,wisconsin_exoplanets-openailong","1,2,4",0.49206349206349204,0.36375935999913483,0.6211382372598804,63,31,0.5757575757575758,0.4478940377087594,0.6965980669616616,66,38,12,18,22,14,19,20,10,14
"wisconsin_exoplanets-falcon,wisconsin_exoplanets-geminipro10,wisconsin_exoplanets-openai10o1","1,3,5",0.49206349206349204,0.36375935999913483,0.6211382372598804,63,31,0.5606060606060606,0.43296119670295957,0.6826341362307495,66,37,13,15,23,12,18,22,9,17
"wisconsin_exoplanets-llama,wisconsin_exoplanets-llamaphi,wisconsin_exoplanets-qwq","2,1,1",0.49206349206349204,0.36375935999913483,0.6211382372598804,63,31,0.5303030303030303,0.403420053441725,0.654378697236779,66,35,15,23,25,22,16,12,7,9
"wisconsin_exoplanets-anthropic10,wisconsin_exoplanets-geminipro,wisconsin_exoplanets-openailong","1,2,4",0.49206349206349204,0.36375935999913483,0.6211382372598804,63,31,0.5454545454545454,0.4181368331466126,0.6685606183790747,66,36,10,19,20,17,21,17,12,13
"wisconsin_exoplanets-anthropic10,wisconsin_exoplanets-falcon10,wisconsin_exoplanets-llamaphi","1,1,1",0.49206349206349204,0.36375935999913483,0.6211382372598804,63,31,0.48484848484848486,0.3599107557499768,0.6111897347222226,66,32,16,24,26,26,15,8,6,8
"wisconsin_exoplanets-falcon10,wisconsin_exoplanets-openailong,wisconsin_exoplanets-qwq","1,4,1",0.49206349206349204,0.36375935999913483,0.6211382372598804,63,31,0.5303030303030303,0.403420053441725,0.654378697236779,66,35,16,24,26,23,15,11,6,8
"wisconsin_exoplanets-falcon,wisconsin_exoplanets-llamaphi,wisconsin_exoplanets-openai4510","1,1,2",0.49206349206349204,0.36375935999913483,0.6211382372598804,63,31,0.5606060606060606,0.43296119670295957,0.6826341362307495,66,37,12,17,22,14,19,20,10,15
"wisconsin_exoplanets-geminipro10,wisconsin_exoplanets-openai45,wisconsin_exoplanets-phi","3,4,1",0.49206349206349204,0.36375935999913483,0.6211382372598804,63,31,0.5909090909090909,0.46293656355858825,0.7104508976039902,66,39,13,17,23,12,18,22,9,15
"wisconsin_exoplanets-falcon10,wisconsin_exoplanets-openai45,wisconsin_exoplanets-qwq","1,4,1",0.49206349206349204,0.36375935999913483,0.6211382372598804,63,31,0.5303030303030303,0.403420053441725,0.654378697236779,66,35,16,24,26,23,15,11,6,8
"wisconsin_exoplanets-falcon10,wisconsin_exoplanets-openai10o1,wisconsin_exoplanets-qwq","1,5,1",0.49206349206349204,0.36375935999913483,0.6211382372598804,63,31,0.5454545454545454,0.4181368331466126,0.6685606183790747,66,36,15,23,25,21,16,13,7,9
"wisconsin_exoplanets-falcon10,wisconsin_exoplanets-openai10,wisconsin_exoplanets-qwq","1,5,1",0.49206349206349204,0.36375935999913483,0.6211382372598804,63,31,0.5454545454545454,0.4181368331466126,0.6685606183790747,66,36,16,25,26,23,15,11,6,7
"wisconsin_exoplanets-anthropic10,wisconsin_exoplanets-deepseek,wisconsin_exoplanets-openai10o1","1,1,5",0.49206349206349204,0.36375935999913483,0.6211382372598804,63,31,0.5454545454545454,0.4181368331466126,0.6685606183790747,66,36,18,25,28,23,13,11,4,7
"wisconsin_exoplanets-geminipro10,wisconsin_exoplanets-openailong,wisconsin_exoplanets-phi","3,4,1",0.49206349206349204,0.36375935999913483,0.6211382372598804,63,31,0.5757575757575758,0.4478940377087594,0.6965980669616616,66,38,12,17,22,13,19,21,10,15
"wisconsin_exoplanets-gemini10,wisconsin_exoplanets-openai10,wisconsin_exoplanets-qwq","2,5,1",0.49206349206349204,0.36375935999913483,0.6211382372598804,63,31,0.5606060606060606,0.43296119670295957,0.6826341362307495,66,37,8,17,18,14,23,20,14,15
"wisconsin_exoplanets-anthropic10,wisconsin_exoplanets-deepseek,wisconsin_exoplanets-openai","1,1,6",0.49206349206349204,0.36375935999913483,0.6211382372598804,63,31,0.5303030303030303,0.403420053441725,0.654378697236779,66,35,18,25,28,24,13,10,4,7
"wisconsin_exoplanets-anthropic10,wisconsin_exoplanets-openai,wisconsin_exoplanets-openai10o1","1,6,5",0.49206349206349204,0.36375935999913483,0.6211382372598804,63,31,0.5,0.37430716945155507,0.6256928305484449,66,33,11,19,21,20,20,14,11,13
"wisconsin_exoplanets-gemini10,wisconsin_exoplanets-openai10o1,wisconsin_exoplanets-qwq","2,5,1",0.49206349206349204,0.36375935999913483,0.6211382372598804,63,31,0.5454545454545454,0.4181368331466126,0.6685606183790747,66,36,9,15,19,13,22,21,13,17
"wisconsin_exoplanets-anthropic10,wisconsin_exoplanets-openai,wisconsin_exoplanets-openai45","1,6,4",0.49206349206349204,0.36375935999913483,0.6211382372598804,63,31,0.5151515151515151,0.3888102652777774,0.6400892442500232,66,34,12,20,22,20,19,14,10,12
"wisconsin_exoplanets-anthropic10,wisconsin_exoplanets-deepseek,wisconsin_exoplanets-llamaphi","1,1,1",0.49206349206349204,0.36375935999913483,0.6211382372598804,63,31,0.5,0.37430716945155507,0.6256928305484449,66,33,18,25,28,26,13,8,4,7
"wisconsin_exoplanets-anthropic10,wisconsin_exoplanets-falcon10,wisconsin_exoplanets-openai10","1,1,5",0.49206349206349204,0.36375935999913483,0.6211382372598804,63,31,0.5,0.37430716945155507,0.6256928305484449,66,33,16,25,26,26,15,8,6,7
"wisconsin_exoplanets-anthropic10,wisconsin_exoplanets-falcon10,wisconsin_exoplanets-openai45","1,1,4",0.49206349206349204,0.36375935999913483,0.6211382372598804,63,31,0.48484848484848486,0.3599107557499768,0.6111897347222226,66,32,17,24,27,26,14,8,5,8
"wisconsin_exoplanets-falcon10,wisconsin_exoplanets-gemma,wisconsin_exoplanets-qwq","1,1,1",0.49206349206349204,0.36375935999913483,0.6211382372598804,63,31,0.5151515151515151,0.3888102652777774,0.6400892442500232,66,34,12,14,22,14,19,20,10,18
"wisconsin_exoplanets-deepseek,wisconsin_exoplanets-openai45,wisconsin_exoplanets-qwq","1,4,1",0.49206349206349204,0.36375935999913483,0.6211382372598804,63,31,0.5454545454545454,0.4181368331466126,0.6685606183790747,66,36,15,23,25,21,16,13,7,9
"wisconsin_exoplanets-anthropic10,wisconsin_exoplanets-geminipro10,wisconsin_exoplanets-openai45","1,3,4",0.49206349206349204,0.36375935999913483,0.6211382372598804,63,31,0.5757575757575758,0.4478940377087594,0.6965980669616616,66,38,12,20,22,16,19,18,10,12
"wisconsin_exoplanets-llamaphi,wisconsin_exoplanets-openai10o1,wisconsin_exoplanets-openailong","1,5,4",0.48,0.3366050916034599,0.6258480549209058,50,24,0.43859649122807015,0.3074154334404188,0.576378581253424,57,25,8,13,21,16,16,12,5,16
"wisconsin_exoplanets-llamaphi,wisconsin_exoplanets-openai10o1,wisconsin_exoplanets-openai45","1,5,4",0.48,0.3366050916034599,0.6258480549209058,50,24,0.43859649122807015,0.3074154334404188,0.576378581253424,57,25,8,13,21,16,16,12,5,16
"wisconsin_exoplanets-llamaphi,wisconsin_exoplanets-openai4510,wisconsin_exoplanets-openaio1","1,2,2",0.48,0.3366050916034599,0.6258480549209058,50,24,0.43859649122807015,0.3074154334404188,0.576378581253424,57,25,8,12,21,15,16,13,5,17
"wisconsin_exoplanets-llamaphi,wisconsin_exoplanets-openai10,wisconsin_exoplanets-openai4510","1,5,2",0.48,0.3366050916034599,0.6258480549209058,50,24,0.47368421052631576,0.339848322631531,0.6103478223726841,57,27,8,15,21,16,16,12,5,14
"wisconsin_exoplanets-llamaphi,wisconsin_exoplanets-openai10o1,wisconsin_exoplanets-openai4510","1,5,2",0.48,0.3366050916034599,0.6258480549209058,50,24,0.43859649122807015,0.3074154334404188,0.576378581253424,57,25,8,13,21,16,16,12,5,16
"wisconsin_exoplanets-llamaphi,wisconsin_exoplanets-openai4510,wisconsin_exoplanets-qwq","1,2,1",0.48,0.3366050916034599,0.6258480549209058,50,24,0.42105263157894735,0.29143407667324656,0.5591613734215395,57,24,8,12,21,16,16,12,5,17
"wisconsin_exoplanets-falcon,wisconsin_exoplanets-llama,wisconsin_exoplanets-qwq","1,2,1",0.47619047619047616,0.34877671126628973,0.6059162449215374,63,30,0.5,0.37430716945155507,0.6256928305484449,66,33,9,15,20,16,21,18,13,17
"wisconsin_exoplanets-gemini,wisconsin_exoplanets-openai10,wisconsin_exoplanets-phi","7,5,1",0.47619047619047616,0.34877671126628973,0.6059162449215374,63,30,0.5757575757575758,0.4478940377087594,0.6965980669616616,66,38,17,23,28,19,13,15,5,9
"wisconsin_exoplanets-falcon,wisconsin_exoplanets-openai10o1,wisconsin_exoplanets-openai4510","1,5,2",0.47619047619047616,0.34877671126628973,0.6059162449215374,63,30,0.6212121212121212,0.4933571772023376,0.7378154230046878,66,41,12,18,23,11,18,23,10,14
"wisconsin_exoplanets-falcon10,wisconsin_exoplanets-gemma,wisconsin_exoplanets-openai10","1,1,5",0.47619047619047616,0.34877671126628973,0.6059162449215374,63,30,0.5454545454545454,0.4181368331466126,0.6685606183790747,66,36,16,25,27,23,14,11,6,7
"wisconsin_exoplanets-deepseek,wisconsin_exoplanets-falcon,wisconsin_exoplanets-openai","1,1,6",0.47619047619047616,0.34877671126628973,0.6059162449215374,63,30,0.5303030303030303,0.403420053441725,0.654378697236779,66,35,16,24,27,23,14,11,6,8
"wisconsin_exoplanets-falcon,wisconsin_exoplanets-geminipro,wisconsin_exoplanets-openai","1,2,6",0.47619047619047616,0.34877671126628973,0.6059162449215374,63,30,0.5303030303030303,0.403420053441725,0.654378697236779,66,35,11,15,22,14,19,20,11,17
"wisconsin_exoplanets-falcon,wisconsin_exoplanets-llama,wisconsin_exoplanets-phi","1,2,1",0.47619047619047616,0.34877671126628973,0.6059162449215374,63,30,0.5303030303030303,0.403420053441725,0.654378697236779,66,35,10,17,21,16,20,18,12,15
"wisconsin_exoplanets-llama,wisconsin_exoplanets-openai45,wisconsin_exoplanets-phi","2,4,1",0.47619047619047616,0.34877671126628973,0.6059162449215374,63,30,0.5606060606060606,0.43296119670295957,0.6826341362307495,66,37,17,27,28,24,13,10,5,5
"wisconsin_exoplanets-falcon10,wisconsin_exoplanets-llamaphi,wisconsin_exoplanets-phi","1,1,1",0.47619047619047616,0.34877671126628973,0.6059162449215374,63,30,0.5454545454545454,0.4181368331466126,0.6685606183790747,66,36,16,26,27,24,14,10,6,6
"wisconsin_exoplanets-falcon,wisconsin_exoplanets-openailong,wisconsin_exoplanets-phi","1,4,1",0.47619047619047616,0.34877671126628973,0.6059162449215374,63,30,0.5,0.37430716945155507,0.6256928305484449,66,33,16,21,27,22,14,12,6,11
"wisconsin_exoplanets-deepseek,wisconsin_exoplanets-falcon,wisconsin_exoplanets-qwq","1,1,1",0.47619047619047616,0.34877671126628973,0.6059162449215374,63,30,0.5303030303030303,0.403420053441725,0.654378697236779,66,35,9,14,20,13,21,21,13,18
"wisconsin_exoplanets-gemini,wisconsin_exoplanets-openai10o1,wisconsin_exoplanets-phi","7,5,1",0.47619047619047616,0.34877671126628973,0.6059162449215374,63,30,0.6060606060606061,0.47809031269657515,0.7241907640463761,66,40,17,23,28,17,13,17,5,9
"wisconsin_exoplanets-anthropic10,wisconsin_exoplanets-openai,wisconsin_exoplanets-openai10","1,6,5",0.47619047619047616,0.34877671126628973,0.6059162449215374,63,30,0.5303030303030303,0.403420053441725,0.654378697236779,66,35,11,21,22,20,19,14,11,11
"wisconsin_exoplanets-anthropic10,wisconsin_exoplanets-openai,wisconsin_exoplanets-openailong","1,6,4",0.47619047619047616,0.34877671126628973,0.6059162449215374,63,30,0.5151515151515151,0.3888102652777774,0.6400892442500232,66,34,11,20,22,20,19,14,11,12
"wisconsin_exoplanets-gemma,wisconsin_exoplanets-openai10o1,wisconsin_exoplanets-phi","1,5,1",0.47619047619047616,0.34877671126628973,0.6059162449215374,63,30,0.48484848484848486,0.3599107557499768,0.6111897347222226,66,32,16,19,27,21,14,13,6,13
"wisconsin_exoplanets-geminipro10,wisconsin_exoplanets-openai10,wisconsin_exoplanets-phi","3,5,1",0.47619047619047616,0.34877671126628973,0.6059162449215374,63,30,0.5757575757575758,0.4478940377087594,0.6965980669616616,66,38,11,17,22,13,19,21,11,15
"wisconsin_exoplanets-anthropic10,wisconsin_exoplanets-gemma,wisconsin_exoplanets-openai","1,1,6",0.47619047619047616,0.34877671126628973,0.6059162449215374,63,30,0.4696969696969697,0.345621302763221,0.5965799465582751,66,31,18,21,29,24,12,10,4,11
"wisconsin_exoplanets-geminipro10,wisconsin_exoplanets-openai10o1,wisconsin_exoplanets-phi","3,5,1",0.47619047619047616,0.34877671126628973,0.6059162449215374,63,30,0.5606060606060606,0.43296119670295957,0.6826341362307495,66,37,12,17,23,14,18,20,10,15
"wisconsin_exoplanets-anthropic10,wisconsin_exoplanets-gemma,wisconsin_exoplanets-qwq","1,1,1",0.47619047619047616,0.34877671126628973,0.6059162449215374,63,30,0.3939393939393939,0.2758092359536239,0.5219096873034248,66,26,7,10,18,18,23,16,15,22
"wisconsin_exoplanets-anthropic10,wisconsin_exoplanets-geminipro10,wisconsin_exoplanets-openai10o1","1,3,5",0.47619047619047616,0.34877671126628973,0.6059162449215374,63,30,0.5606060606060606,0.43296119670295957,0.6826341362307495,66,37,11,19,22,16,19,18,11,13
"wisconsin_exoplanets-anthropic10,wisconsin_exoplanets-geminipro10,wisconsin_exoplanets-openai10","1,3,5",0.47619047619047616,0.34877671126628973,0.6059162449215374,63,30,0.5606060606060606,0.43296119670295957,0.6826341362307495,66,37,11,20,22,17,19,17,11,12
"wisconsin_exoplanets-anthropic10,wisconsin_exoplanets-geminipro,wisconsin_exoplanets-openai45","1,2,4",0.47619047619047616,0.34877671126628973,0.6059162449215374,63,30,0.5606060606060606,0.43296119670295957,0.6826341362307495,66,37,10,19,21,16,20,18,12,13
"wisconsin_exoplanets-gemma,wisconsin_exoplanets-openailong,wisconsin_exoplanets-phi","1,4,1",0.47619047619047616,0.34877671126628973,0.6059162449215374,63,30,0.4696969696969697,0.345621302763221,0.5965799465582751,66,31,17,19,28,22,13,12,5,13
"wisconsin_exoplanets-anthropic10,wisconsin_exoplanets-deepseek,wisconsin_exoplanets-qwq","1,1,1",0.47619047619047616,0.34877671126628973,0.6059162449215374,63,30,0.5303030303030303,0.403420053441725,0.654378697236779,66,35,7,17,18,16,23,18,15,15
"wisconsin_exoplanets-anthropic10,wisconsin_exoplanets-falcon,wisconsin_exoplanets-llama","1,1,2",0.47619047619047616,0.34877671126628973,0.6059162449215374,63,30,0.5,0.37430716945155507,0.6256928305484449,66,33,10,17,21,18,20,16,12,15
"wisconsin_exoplanets-falcon,wisconsin_exoplanets-falcon10,wisconsin_exoplanets-phi","1,1,1",0.47619047619047616,0.34877671126628973,0.6059162449215374,63,30,0.5303030303030303,0.403420053441725,0.654378697236779,66,35,11,17,22,16,19,18,11,15
"wisconsin_exoplanets-gemini,wisconsin_exoplanets-openailong,wisconsin_exoplanets-phi","7,4,1",0.47619047619047616,0.34877671126628973,0.6059162449215374,63,30,0.5757575757575758,0.4478940377087594,0.6965980669616616,66,38,17,23,28,19,13,15,5,9
"wisconsin_exoplanets-geminipro,wisconsin_exoplanets-openai10o1,wisconsin_exoplanets-phi","2,5,1",0.47619047619047616,0.34877671126628973,0.6059162449215374,63,30,0.5303030303030303,0.403420053441725,0.654378697236779,66,35,11,15,22,14,19,20,11,17
"wisconsin_exoplanets-anthropic10,wisconsin_exoplanets-gemini10,wisconsin_exoplanets-openai10o1","1,2,5",0.47619047619047616,0.34877671126628973,0.6059162449215374,63,30,0.5606060606060606,0.43296119670295957,0.6826341362307495,66,37,10,19,21,16,20,18,12,13
"wisconsin_exoplanets-falcon,wisconsin_exoplanets-gemini10,wisconsin_exoplanets-openai45","1,2,4",0.47619047619047616,0.34877671126628973,0.6059162449215374,63,30,0.5757575757575758,0.4478940377087594,0.6965980669616616,66,38,11,18,22,14,19,20,11,14
"wisconsin_exoplanets-anthropic10,wisconsin_exoplanets-gemini10,wisconsin_exoplanets-openai10","1,2,5",0.47619047619047616,0.34877671126628973,0.6059162449215374,63,30,0.5606060606060606,0.43296119670295957,0.6826341362307495,66,37,10,20,21,17,20,17,12,12
"wisconsin_exoplanets-falcon10,wisconsin_exoplanets-openailong,wisconsin_exoplanets-phi","1,4,1",0.4603174603174603,0.3339143379663023,0.590574472760441,63,29,0.5757575757575758,0.4478940377087594,0.6965980669616616,66,38,17,27,29,23,12,11,5,5
"wisconsin_exoplanets-anthropic10,wisconsin_exoplanets-falcon,wisconsin_exoplanets-falcon10","1,1,1",0.4603174603174603,0.3339143379663023,0.590574472760441,63,29,0.5454545454545454,0.4181368331466126,0.6685606183790747,66,36,9,18,21,16,20,18,13,14
"wisconsin_exoplanets-anthropic10,wisconsin_exoplanets-llamaphi,wisconsin_exoplanets-openai10o1","1,1,5",0.4603174603174603,0.3339143379663023,0.590574472760441,63,29,0.48484848484848486,0.3599107557499768,0.6111897347222226,66,32,10,18,22,20,19,14,12,14
"wisconsin_exoplanets-anthropic10,wisconsin_exoplanets-llamaphi,wisconsin_exoplanets-openai45","1,1,4",0.4603174603174603,0.3339143379663023,0.590574472760441,63,29,0.5,0.37430716945155507,0.6256928305484449,66,33,11,19,23,20,18,14,11,13
"wisconsin_exoplanets-gemma,wisconsin_exoplanets-llamaphi,wisconsin_exoplanets-phi","1,1,1",0.4603174603174603,0.3339143379663023,0.590574472760441,63,29,0.48484848484848486,0.3599107557499768,0.6111897347222226,66,32,16,20,28,22,13,12,6,12
"wisconsin_exoplanets-falcon,wisconsin_exoplanets-gemma,wisconsin_exoplanets-phi","1,1,1",0.4603174603174603,0.3339143379663023,0.590574472760441,63,29,0.4696969696969697,0.345621302763221,0.5965799465582751,66,31,9,12,21,15,20,19,13,20
"wisconsin_exoplanets-falcon,wisconsin_exoplanets-llama,wisconsin_exoplanets-openai45","1,2,4",0.4603174603174603,0.3339143379663023,0.590574472760441,63,29,0.5757575757575758,0.4478940377087594,0.6965980669616616,66,38,17,25,29,21,12,13,5,7
"wisconsin_exoplanets-llama,wisconsin_exoplanets-llamaphi,wisconsin_exoplanets-phi","2,1,1",0.4603174603174603,0.3339143379663023,0.590574472760441,63,29,0.5454545454545454,0.4181368331466126,0.6685606183790747,66,36,17,25,29,23,12,11,5,7
"wisconsin_exoplanets-falcon,wisconsin_exoplanets-llamaphi,wisconsin_exoplanets-phi","1,1,1",0.4603174603174603,0.3339143379663023,0.590574472760441,63,29,0.4696969696969697,0.345621302763221,0.5965799465582751,66,31,16,19,28,22,13,12,6,13
"wisconsin_exoplanets-anthropic10,wisconsin_exoplanets-gemma,wisconsin_exoplanets-openailong","1,1,4",0.4603174603174603,0.3339143379663023,0.590574472760441,63,29,0.45454545454545453,0.3314393816209253,0.5818631668533873,66,30,17,22,29,26,12,8,5,10
"wisconsin_exoplanets-anthropic10,wisconsin_exoplanets-gemma,wisconsin_exoplanets-openai45","1,1,4",0.4603174603174603,0.3339143379663023,0.590574472760441,63,29,0.45454545454545453,0.3314393816209253,0.5818631668533873,66,30,18,22,30,26,11,8,4,10
"wisconsin_exoplanets-anthropic10,wisconsin_exoplanets-gemma,wisconsin_exoplanets-llamaphi","1,1,1",0.4603174603174603,0.3339143379663023,0.590574472760441,63,29,0.4696969696969697,0.345621302763221,0.5965799465582751,66,31,17,22,29,25,12,9,5,10
"wisconsin_exoplanets-falcon,wisconsin_exoplanets-gemma,wisconsin_exoplanets-openailong","1,1,4",0.4603174603174603,0.3339143379663023,0.590574472760441,63,29,0.5,0.37430716945155507,0.6256928305484449,66,33,18,20,30,21,11,13,4,12
"wisconsin_exoplanets-falcon10,wisconsin_exoplanets-gemma,wisconsin_exoplanets-openai10o1","1,1,5",0.4603174603174603,0.3339143379663023,0.590574472760441,63,29,0.5757575757575758,0.4478940377087594,0.6965980669616616,66,38,15,24,27,20,14,14,7,8
"wisconsin_exoplanets-anthropic10,wisconsin_exoplanets-geminipro,wisconsin_exoplanets-openai10","1,2,5",0.4603174603174603,0.3339143379663023,0.590574472760441,63,29,0.5454545454545454,0.4181368331466126,0.6685606183790747,66,36,9,19,21,17,20,17,13,13
"wisconsin_exoplanets-falcon,wisconsin_exoplanets-falcon10,wisconsin_exoplanets-qwq","1,1,1",0.4603174603174603,0.3339143379663023,0.590574472760441,63,29,0.5303030303030303,0.403420053441725,0.654378697236779,66,35,8,13,20,12,21,22,14,19
"wisconsin_exoplanets-falcon,wisconsin_exoplanets-openai,wisconsin_exoplanets-phi","1,6,1",0.4603174603174603,0.3339143379663023,0.590574472760441,63,29,0.5151515151515151,0.3888102652777774,0.6400892442500232,66,34,16,20,28,20,13,14,6,12
"wisconsin_exoplanets-deepseek,wisconsin_exoplanets-falcon,wisconsin_exoplanets-llamaphi","1,1,1",0.4603174603174603,0.3339143379663023,0.590574472760441,63,29,0.5151515151515151,0.3888102652777774,0.6400892442500232,66,34,16,24,28,24,13,10,6,8
"wisconsin_exoplanets-falcon,wisconsin_exoplanets-openai10,wisconsin_exoplanets-openai4510","1,5,2",0.4603174603174603,0.3339143379663023,0.590574472760441,63,29,0.5757575757575758,0.4478940377087594,0.6965980669616616,66,38,11,18,23,14,18,20,11,14
"wisconsin_exoplanets-falcon,wisconsin_exoplanets-falcon10,wisconsin_exoplanets-openai","1,1,6",0.4603174603174603,0.3339143379663023,0.590574472760441,63,29,0.5606060606060606,0.43296119670295957,0.6826341362307495,66,37,16,25,28,22,13,12,6,7
"wisconsin_exoplanets-falcon,wisconsin_exoplanets-openai45,wisconsin_exoplanets-phi","1,4,1",0.4603174603174603,0.3339143379663023,0.590574472760441,63,29,0.5151515151515151,0.3888102652777774,0.6400892442500232,66,34,16,21,28,21,13,13,6,11
"wisconsin_exoplanets-anthropic10,wisconsin_exoplanets-falcon10,wisconsin_exoplanets-openai10o1","1,1,5",0.4603174603174603,0.3339143379663023,0.590574472760441,63,29,0.5151515151515151,0.3888102652777774,0.6400892442500232,66,34,16,24,28,24,13,10,6,8
"wisconsin_exoplanets-falcon,wisconsin_exoplanets-llama,wisconsin_exoplanets-openailong","1,2,4",0.4603174603174603,0.3339143379663023,0.590574472760441,63,29,0.5606060606060606,0.43296119670295957,0.6826341362307495,66,37,17,25,29,22,12,12,5,7
"wisconsin_exoplanets-falcon,wisconsin_exoplanets-gemma,wisconsin_exoplanets-openai45","1,1,4",0.4603174603174603,0.3339143379663023,0.590574472760441,63,29,0.5151515151515151,0.3888102652777774,0.6400892442500232,66,34,18,20,30,20,11,14,4,12
"wisconsin_exoplanets-gemini,wisconsin_exoplanets-openai45,wisconsin_exoplanets-phi","7,4,1",0.4603174603174603,0.3339143379663023,0.590574472760441,63,29,0.5909090909090909,0.46293656355858825,0.7104508976039902,66,39,17,23,29,18,12,16,5,9
"wisconsin_exoplanets-gemma,wisconsin_exoplanets-openai45,wisconsin_exoplanets-phi","1,4,1",0.4603174603174603,0.3339143379663023,0.590574472760441,63,29,0.4696969696969697,0.345621302763221,0.5965799465582751,66,31,17,19,29,22,12,12,5,13
"wisconsin_exoplanets-falcon,wisconsin_exoplanets-geminipro,wisconsin_exoplanets-openai45","1,2,4",0.4603174603174603,0.3339143379663023,0.590574472760441,63,29,0.5151515151515151,0.3888102652777774,0.6400892442500232,66,34,11,15,23,15,18,19,11,17
"wisconsin_exoplanets-anthropic10,wisconsin_exoplanets-openai10o1,wisconsin_exoplanets-openai45","1,5,4",0.4603174603174603,0.3339143379663023,0.590574472760441,63,29,0.5,0.37430716945155507,0.6256928305484449,66,33,10,18,22,19,19,15,12,14
"wisconsin_exoplanets-falcon,wisconsin_exoplanets-gemini10,wisconsin_exoplanets-openailong","1,2,4",0.4603174603174603,0.3339143379663023,0.590574472760441,63,29,0.5757575757575758,0.4478940377087594,0.6965980669616616,66,38,10,18,22,14,19,20,12,14
"wisconsin_exoplanets-falcon,wisconsin_exoplanets-geminipro,wisconsin_exoplanets-llamaphi","1,2,1",0.4603174603174603,0.3339143379663023,0.590574472760441,63,29,0.5,0.37430716945155507,0.6256928305484449,66,33,11,14,23,15,18,19,11,18
"wisconsin_exoplanets-gemma,wisconsin_exoplanets-openai10,wisconsin_exoplanets-phi","1,5,1",0.4603174603174603,0.3339143379663023,0.590574472760441,63,29,0.48484848484848486,0.3599107557499768,0.6111897347222226,66,32,16,20,28,22,13,12,6,12
"wisconsin_exoplanets-falcon,wisconsin_exoplanets-gemini10,wisconsin_exoplanets-llamaphi","1,2,1",0.4603174603174603,0.3339143379663023,0.590574472760441,63,29,0.5757575757575758,0.4478940377087594,0.6965980669616616,66,38,10,18,22,14,19,20,12,14
"wisconsin_exoplanets-anthropic10,wisconsin_exoplanets-openai10,wisconsin_exoplanets-openailong","1,5,4",0.4603174603174603,0.3339143379663023,0.590574472760441,63,29,0.5303030303030303,0.403420053441725,0.654378697236779,66,35,9,18,21,17,20,17,13,14
"wisconsin_exoplanets-llama,wisconsin_exoplanets-openai,wisconsin_exoplanets-phi","2,6,1",0.4603174603174603,0.3339143379663023,0.590574472760441,63,29,0.5606060606060606,0.43296119670295957,0.6826341362307495,66,37,17,25,29,22,12,12,5,7
"wisconsin_exoplanets-anthropic10,wisconsin_exoplanets-openai45,wisconsin_exoplanets-openailong","1,4,4",0.4603174603174603,0.3339143379663023,0.590574472760441,63,29,0.5303030303030303,0.403420053441725,0.654378697236779,66,35,9,18,21,17,20,17,13,14
"wisconsin_exoplanets-falcon,wisconsin_exoplanets-gemma,wisconsin_exoplanets-openai","1,1,6",0.4603174603174603,0.3339143379663023,0.590574472760441,63,29,0.5,0.37430716945155507,0.6256928305484449,66,33,18,20,30,21,11,13,4,12
"wisconsin_exoplanets-llamaphi,wisconsin_exoplanets-openai10o1,wisconsin_exoplanets-openaio1","1,5,2",0.46,0.31814917856860864,0.6067580238830776,50,23,0.40350877192982454,0.2756127242679726,0.5417865985973231,57,23,8,12,22,17,15,11,5,17
"wisconsin_exoplanets-llamaphi,wisconsin_exoplanets-openaio1,wisconsin_exoplanets-phi","1,2,1",0.46,0.31814917856860864,0.6067580238830776,50,23,0.40350877192982454,0.2756127242679726,0.5417865985973231,57,23,7,11,21,16,16,12,6,18
"wisconsin_exoplanets-llamaphi,wisconsin_exoplanets-openai45,wisconsin_exoplanets-openaio1","1,4,2",0.46,0.31814917856860864,0.6067580238830776,50,23,0.43859649122807015,0.3074154334404188,0.576378581253424,57,25,9,14,23,17,14,11,4,15
"wisconsin_exoplanets-llamaphi,wisconsin_exoplanets-openai10,wisconsin_exoplanets-openai10o1","1,5,5",0.46,0.31814917856860864,0.6067580238830776,50,23,0.43859649122807015,0.3074154334404188,0.576378581253424,57,25,7,13,21,16,16,12,6,16
"wisconsin_exoplanets-llamaphi,wisconsin_exoplanets-openailong,wisconsin_exoplanets-openaio1","1,4,2",0.46,0.31814917856860864,0.6067580238830776,50,23,0.43859649122807015,0.3074154334404188,0.576378581253424,57,25,9,14,23,17,14,11,4,15
"wisconsin_exoplanets-falcon,wisconsin_exoplanets-openai10,wisconsin_exoplanets-phi","1,5,1",0.4444444444444444,0.31917312627195704,0.5751123730173897,63,28,0.5,0.37430716945155507,0.6256928305484449,66,33,15,21,28,22,13,12,7,11
"wisconsin_exoplanets-falcon,wisconsin_exoplanets-openai45,wisconsin_exoplanets-openailong","1,4,4",0.4444444444444444,0.31917312627195704,0.5751123730173897,63,28,0.5,0.37430716945155507,0.6256928305484449,66,33,9,13,22,14,19,20,13,19
"wisconsin_exoplanets-falcon,wisconsin_exoplanets-gemini10,wisconsin_exoplanets-openai10","1,2,5",0.4444444444444444,0.31917312627195704,0.5751123730173897,63,28,0.5757575757575758,0.4478940377087594,0.6965980669616616,66,38,10,18,23,14,18,20,12,14
"wisconsin_exoplanets-anthropic10,wisconsin_exoplanets-geminipro,wisconsin_exoplanets-openai10o1","1,2,5",0.4444444444444444,0.31917312627195704,0.5751123730173897,63,28,0.5454545454545454,0.4181368331466126,0.6685606183790747,66,36,8,18,21,16,20,18,14,14
"wisconsin_exoplanets-falcon,wisconsin_exoplanets-geminipro,wisconsin_exoplanets-openai10o1","1,2,5",0.4444444444444444,0.31917312627195704,0.5751123730173897,63,28,0.5454545454545454,0.4181368331466126,0.6685606183790747,66,36,11,14,24,12,17,22,11,18
"wisconsin_exoplanets-anthropic10,wisconsin_exoplanets-llamaphi,wisconsin_exoplanets-openailong","1,1,4",0.4444444444444444,0.31917312627195704,0.5751123730173897,63,28,0.5,0.37430716945155507,0.6256928305484449,66,33,10,19,23,20,18,14,12,13
"wisconsin_exoplanets-anthropic10,wisconsin_exoplanets-openai10o1,wisconsin_exoplanets-openailong","1,5,4",0.4444444444444444,0.31917312627195704,0.5751123730173897,63,28,0.5,0.37430716945155507,0.6256928305484449,66,33,9,18,22,19,19,15,13,14
"wisconsin_exoplanets-anthropic10,wisconsin_exoplanets-openai10,wisconsin_exoplanets-openai45","1,5,4",0.4444444444444444,0.31917312627195704,0.5751123730173897,63,28,0.5303030303030303,0.403420053441725,0.654378697236779,66,35,9,18,22,17,19,17,13,14
"wisconsin_exoplanets-falcon,wisconsin_exoplanets-gemma,wisconsin_exoplanets-openai10","1,1,5",0.4444444444444444,0.31917312627195704,0.5751123730173897,63,28,0.5151515151515151,0.3888102652777774,0.6400892442500232,66,34,18,21,31,21,10,13,4,11
"wisconsin_exoplanets-deepseek,wisconsin_exoplanets-falcon,wisconsin_exoplanets-phi","1,1,1",0.4444444444444444,0.31917312627195704,0.5751123730173897,63,28,0.5303030303030303,0.403420053441725,0.654378697236779,66,35,10,14,23,13,18,21,12,18
"wisconsin_exoplanets-deepseek,wisconsin_exoplanets-falcon,wisconsin_exoplanets-openailong","1,1,4",0.4444444444444444,0.31917312627195704,0.5751123730173897,63,28,0.5151515151515151,0.3888102652777774,0.6400892442500232,66,34,16,25,29,25,12,9,6,7
"wisconsin_exoplanets-deepseek,wisconsin_exoplanets-falcon,wisconsin_exoplanets-openai45","1,1,4",0.4444444444444444,0.31917312627195704,0.5751123730173897,63,28,0.5151515151515151,0.3888102652777774,0.6400892442500232,66,34,16,25,29,25,12,9,6,7
"wisconsin_exoplanets-falcon10,wisconsin_exoplanets-openai45,wisconsin_exoplanets-phi","1,4,1",0.4444444444444444,0.31917312627195704,0.5751123730173897,63,28,0.5757575757575758,0.4478940377087594,0.6965980669616616,66,38,17,27,30,23,11,11,5,5
"wisconsin_exoplanets-falcon10,wisconsin_exoplanets-openai10,wisconsin_exoplanets-phi","1,5,1",0.4444444444444444,0.31917312627195704,0.5751123730173897,63,28,0.5909090909090909,0.46293656355858825,0.7104508976039902,66,39,17,28,30,23,11,11,5,4
"wisconsin_exoplanets-anthropic10,wisconsin_exoplanets-openai,wisconsin_exoplanets-phi","1,6,1",0.4444444444444444,0.31917312627195704,0.5751123730173897,63,28,0.5454545454545454,0.4181368331466126,0.6685606183790747,66,36,15,24,28,22,13,12,7,8
"wisconsin_exoplanets-falcon,wisconsin_exoplanets-gemini10,wisconsin_exoplanets-openai10o1","1,2,5",0.4444444444444444,0.31917312627195704,0.5751123730173897,63,28,0.6060606060606061,0.47809031269657515,0.7241907640463761,66,40,10,17,23,11,18,23,12,15
"wisconsin_exoplanets-falcon,wisconsin_exoplanets-llama,wisconsin_exoplanets-llamaphi","1,2,1",0.4444444444444444,0.31917312627195704,0.5751123730173897,63,28,0.5454545454545454,0.4181368331466126,0.6685606183790747,66,36,17,25,30,23,11,11,5,7
"wisconsin_exoplanets-falcon,wisconsin_exoplanets-llama,wisconsin_exoplanets-openai","1,2,6",0.4444444444444444,0.31917312627195704,0.5751123730173897,63,28,0.5454545454545454,0.4181368331466126,0.6685606183790747,66,36,17,24,30,22,11,12,5,8
"wisconsin_exoplanets-falcon,wisconsin_exoplanets-geminipro,wisconsin_exoplanets-openailong","1,2,4",0.4444444444444444,0.31917312627195704,0.5751123730173897,63,28,0.5151515151515151,0.3888102652777774,0.6400892442500232,66,34,10,15,23,15,18,19,12,17
"wisconsin_exoplanets-anthropic10,wisconsin_exoplanets-gemma,wisconsin_exoplanets-openai10o1","1,1,5",0.4444444444444444,0.31917312627195704,0.5751123730173897,63,28,0.48484848484848486,0.3599107557499768,0.6111897347222226,66,32,17,21,30,23,11,11,5,11
"wisconsin_exoplanets-falcon,wisconsin_exoplanets-gemma,wisconsin_exoplanets-qwq","1,1,1",0.4444444444444444,0.31917312627195704,0.5751123730173897,63,28,0.42424242424242425,0.30340193303833835,0.5521059622912405,66,28,7,9,20,15,21,19,15,23
"wisconsin_exoplanets-anthropic10,wisconsin_exoplanets-llama,wisconsin_exoplanets-openai45","1,2,4",0.4444444444444444,0.31917312627195704,0.5751123730173897,63,28,0.5151515151515151,0.3888102652777774,0.6400892442500232,66,34,17,25,30,25,11,9,5,7
"wisconsin_exoplanets-anthropic10,wisconsin_exoplanets-llama,wisconsin_exoplanets-openailong","1,2,4",0.4444444444444444,0.31917312627195704,0.5751123730173897,63,28,0.5151515151515151,0.3888102652777774,0.6400892442500232,66,34,16,25,29,25,12,9,6,7
"wisconsin_exoplanets-anthropic10,wisconsin_exoplanets-llama,wisconsin_exoplanets-openai","1,2,6",0.4444444444444444,0.31917312627195704,0.5751123730173897,63,28,0.5151515151515151,0.3888102652777774,0.6400892442500232,66,34,17,25,30,25,11,9,5,7
"wisconsin_exoplanets-anthropic10,wisconsin_exoplanets-llamaphi,wisconsin_exoplanets-openai10","1,1,5",0.4444444444444444,0.31917312627195704,0.5751123730173897,63,28,0.5151515151515151,0.3888102652777774,0.6400892442500232,66,34,10,20,23,20,18,14,12,12
"wisconsin_exoplanets-llamaphi,wisconsin_exoplanets-openailong,wisconsin_exoplanets-qwq","1,4,1",0.44,0.29990722092754357,0.5874558770583268,50,22,0.47368421052631576,0.339848322631531,0.6103478223726841,57,27,9,15,24,16,13,12,4,14
"wisconsin_exoplanets-llamaphi,wisconsin_exoplanets-openailong,wisconsin_exoplanets-phi","1,4,1",0.44,0.29990722092754357,0.5874558770583268,50,22,0.43859649122807015,0.3074154334404188,0.576378581253424,57,25,8,14,23,17,14,11,5,15
"wisconsin_exoplanets-llamaphi,wisconsin_exoplanets-openai4510,wisconsin_exoplanets-phi","1,2,1",0.44,0.29990722092754357,0.5874558770583268,50,22,0.42105263157894735,0.29143407667324656,0.5591613734215395,57,24,6,11,21,15,16,13,7,18
"wisconsin_exoplanets-llamaphi,wisconsin_exoplanets-openai45,wisconsin_exoplanets-qwq","1,4,1",0.44,0.29990722092754357,0.5874558770583268,50,22,0.47368421052631576,0.339848322631531,0.6103478223726841,57,27,9,15,24,16,13,12,4,14
"wisconsin_exoplanets-llamaphi,wisconsin_exoplanets-openai45,wisconsin_exoplanets-phi","1,4,1",0.44,0.29990722092754357,0.5874558770583268,50,22,0.43859649122807015,0.3074154334404188,0.576378581253424,57,25,8,14,23,17,14,11,5,15
"wisconsin_exoplanets-llamaphi,wisconsin_exoplanets-openai10,wisconsin_exoplanets-openaio1","1,5,2",0.44,0.29990722092754357,0.5874558770583268,50,22,0.43859649122807015,0.3074154334404188,0.576378581253424,57,25,8,14,23,17,14,11,5,15
"wisconsin_exoplanets-falcon,wisconsin_exoplanets-gemma,wisconsin_exoplanets-openai10o1","1,1,5",0.42857142857142855,0.30455434046463875,0.5595290321232311,63,27,0.5303030303030303,0.403420053441725,0.654378697236779,66,35,17,21,31,20,10,14,5,11
"wisconsin_exoplanets-falcon,wisconsin_exoplanets-openai,wisconsin_exoplanets-openai10o1","1,6,5",0.42857142857142855,0.30455434046463875,0.5595290321232311,63,27,0.48484848484848486,0.3599107557499768,0.6111897347222226,66,32,9,14,23,16,18,18,13,18
"wisconsin_exoplanets-falcon,wisconsin_exoplanets-openai,wisconsin_exoplanets-qwq","1,6,1",0.42857142857142855,0.30455434046463875,0.5595290321232311,63,27,0.4696969696969697,0.345621302763221,0.5965799465582751,66,31,12,17,26,20,15,14,10,15
"wisconsin_exoplanets-falcon,wisconsin_exoplanets-geminipro,wisconsin_exoplanets-openai10","1,2,5",0.42857142857142855,0.30455434046463875,0.5595290321232311,63,27,0.5151515151515151,0.3888102652777774,0.6400892442500232,66,34,10,15,24,15,17,19,12,17
"wisconsin_exoplanets-anthropic10,wisconsin_exoplanets-gemma,wisconsin_exoplanets-openai10","1,1,5",0.42857142857142855,0.30455434046463875,0.5595290321232311,63,27,0.4696969696969697,0.345621302763221,0.5965799465582751,66,31,16,23,30,26,11,8,6,9
"wisconsin_exoplanets-falcon,wisconsin_exoplanets-openai,wisconsin_exoplanets-openailong","1,6,4",0.42857142857142855,0.30455434046463875,0.5595290321232311,63,27,0.48484848484848486,0.3599107557499768,0.6111897347222226,66,32,10,14,24,16,17,18,12,18
"wisconsin_exoplanets-falcon,wisconsin_exoplanets-falcon10,wisconsin_exoplanets-llamaphi","1,1,1",0.42857142857142855,0.30455434046463875,0.5595290321232311,63,27,0.5757575757575758,0.4478940377087594,0.6965980669616616,66,38,15,26,29,22,12,12,7,6
"wisconsin_exoplanets-falcon,wisconsin_exoplanets-gemma,wisconsin_exoplanets-llamaphi","1,1,1",0.42857142857142855,0.30455434046463875,0.5595290321232311,63,27,0.48484848484848486,0.3599107557499768,0.6111897347222226,66,32,17,19,31,21,10,13,5,13
"wisconsin_exoplanets-anthropic10,wisconsin_exoplanets-openai10,wisconsin_exoplanets-openai10o1","1,5,5",0.42857142857142855,0.30455434046463875,0.5595290321232311,63,27,0.5151515151515151,0.3888102652777774,0.6400892442500232,66,34,8,19,22,19,19,15,14,13
"wisconsin_exoplanets-falcon,wisconsin_exoplanets-llamaphi,wisconsin_exoplanets-openai","1,1,6",0.42857142857142855,0.30455434046463875,0.5595290321232311,63,27,0.5151515151515151,0.3888102652777774,0.6400892442500232,66,34,8,14,22,14,19,20,14,18
"wisconsin_exoplanets-anthropic10,wisconsin_exoplanets-llama,wisconsin_exoplanets-openai10o1","1,2,5",0.42857142857142855,0.30455434046463875,0.5595290321232311,63,27,0.5303030303030303,0.403420053441725,0.654378697236779,66,35,17,24,31,23,10,11,5,8
"wisconsin_exoplanets-anthropic10,wisconsin_exoplanets-llama,wisconsin_exoplanets-openai10","1,2,5",0.42857142857142855,0.30455434046463875,0.5595290321232311,63,27,0.5151515151515151,0.3888102652777774,0.6400892442500232,66,34,16,25,30,25,11,9,6,7
"wisconsin_exoplanets-falcon,wisconsin_exoplanets-llama,wisconsin_exoplanets-openai10","1,2,5",0.42857142857142855,0.30455434046463875,0.5595290321232311,63,27,0.5606060606060606,0.43296119670295957,0.6826341362307495,66,37,16,25,30,22,11,12,6,7
"wisconsin_exoplanets-falcon,wisconsin_exoplanets-llama,wisconsin_exoplanets-openai10o1","1,2,5",0.42857142857142855,0.30455434046463875,0.5595290321232311,63,27,0.5757575757575758,0.4478940377087594,0.6965980669616616,66,38,15,24,29,20,12,14,7,8
"wisconsin_exoplanets-deepseek,wisconsin_exoplanets-falcon,wisconsin_exoplanets-openai10","1,1,5",0.42857142857142855,0.30455434046463875,0.5595290321232311,63,27,0.5303030303030303,0.403420053441725,0.654378697236779,66,35,15,26,29,25,12,9,7,6
"wisconsin_exoplanets-anthropic10,wisconsin_exoplanets-llama,wisconsin_exoplanets-llamaphi","1,2,1",0.42857142857142855,0.30455434046463875,0.5595290321232311,63,27,0.5,0.37430716945155507,0.6256928305484449,66,33,17,24,31,25,10,9,5,8
"wisconsin_exoplanets-anthropic10,wisconsin_exoplanets-falcon,wisconsin_exoplanets-gemma","1,1,1",0.42857142857142855,0.30455434046463875,0.5595290321232311,63,27,0.3787878787878788,0.2621845769953122,0.5066428227976624,66,25,8,9,22,18,19,16,14,23
"wisconsin_exoplanets-anthropic10,wisconsin_exoplanets-llamaphi,wisconsin_exoplanets-phi","1,1,1",0.42857142857142855,0.30455434046463875,0.5595290321232311,63,27,0.5454545454545454,0.4181368331466126,0.6685606183790747,66,36,15,25,29,23,12,11,7,7
"wisconsin_exoplanets-llamaphi,wisconsin_exoplanets-openai10,wisconsin_exoplanets-qwq","1,5,1",0.42,0.28188224112369753,0.5679395649344343,50,21,0.47368421052631576,0.339848322631531,0.6103478223726841,57,27,8,15,24,16,13,12,5,14
"wisconsin_exoplanets-llamaphi,wisconsin_exoplanets-openai10,wisconsin_exoplanets-phi","1,5,1",0.42,0.28188224112369753,0.5679395649344343,50,21,0.43859649122807015,0.3074154334404188,0.576378581253424,57,25,7,14,23,17,14,11,6,15
"wisconsin_exoplanets-llamaphi,wisconsin_exoplanets-phi,wisconsin_exoplanets-qwq","1,1,1",0.42,0.28188224112369753,0.5679395649344343,50,21,0.40350877192982454,0.2756127242679726,0.5417865985973231,57,23,7,11,23,16,14,12,6,18
"wisconsin_exoplanets-llamaphi,wisconsin_exoplanets-openai10o1,wisconsin_exoplanets-qwq","1,5,1",0.42,0.28188224112369753,0.5679395649344343,50,21,0.43859649122807015,0.3074154334404188,0.576378581253424,57,25,8,13,24,16,13,12,5,16
"wisconsin_exoplanets-llamaphi,wisconsin_exoplanets-openai10o1,wisconsin_exoplanets-phi","1,5,1",0.42,0.28188224112369753,0.5679395649344343,50,21,0.40350877192982454,0.2756127242679726,0.5417865985973231,57,23,7,12,23,17,14,11,6,17
"wisconsin_exoplanets-falcon,wisconsin_exoplanets-phi,wisconsin_exoplanets-qwq","1,1,1",0.4126984126984127,0.2900596423975445,0.543823156750429,63,26,0.4696969696969697,0.345621302763221,0.5965799465582751,66,31,8,12,23,15,18,19,14,20
"wisconsin_exoplanets-deepseek,wisconsin_exoplanets-falcon,wisconsin_exoplanets-openai10o1","1,1,5",0.4126984126984127,0.2900596423975445,0.543823156750429,63,26,0.5606060606060606,0.43296119670295957,0.6826341362307495,66,37,14,25,29,22,12,12,8,7
"wisconsin_exoplanets-falcon,wisconsin_exoplanets-openai10,wisconsin_exoplanets-openai45","1,5,4",0.4126984126984127,0.2900596423975445,0.543823156750429,63,26,0.5,0.37430716945155507,0.6256928305484449,66,33,8,13,23,14,18,20,14,19
"wisconsin_exoplanets-anthropic10,wisconsin_exoplanets-falcon,wisconsin_exoplanets-openai","1,1,6",0.4126984126984127,0.2900596423975445,0.543823156750429,63,26,0.5,0.37430716945155507,0.6256928305484449,66,33,14,22,29,23,12,11,8,10
"wisconsin_exoplanets-falcon,wisconsin_exoplanets-openai10o1,wisconsin_exoplanets-phi","1,5,1",0.4126984126984127,0.2900596423975445,0.543823156750429,63,26,0.5151515151515151,0.3888102652777774,0.6400892442500232,66,34,14,20,29,20,12,14,8,12
"wisconsin_exoplanets-anthropic10,wisconsin_exoplanets-phi,wisconsin_exoplanets-qwq","1,1,1",0.4126984126984127,0.2900596423975445,0.543823156750429,63,26,0.4696969696969697,0.345621302763221,0.5965799465582751,66,31,7,16,22,19,19,15,15,16
"wisconsin_exoplanets-anthropic10,wisconsin_exoplanets-openai,wisconsin_exoplanets-qwq","1,6,1",0.4126984126984127,0.2900596423975445,0.543823156750429,63,26,0.4696969696969697,0.345621302763221,0.5965799465582751,66,31,14,21,29,24,12,10,8,11
"wisconsin_exoplanets-falcon,wisconsin_exoplanets-openai,wisconsin_exoplanets-openai45","1,6,4",0.4126984126984127,0.2900596423975445,0.543823156750429,63,26,0.5,0.37430716945155507,0.6256928305484449,66,33,10,14,25,15,16,19,12,18
"wisconsin_exoplanets-falcon,wisconsin_exoplanets-llamaphi,wisconsin_exoplanets-openai10o1","1,1,5",0.4126984126984127,0.2900596423975445,0.543823156750429,63,26,0.48484848484848486,0.3599107557499768,0.6111897347222226,66,32,8,15,23,17,18,17,14,17
"wisconsin_exoplanets-falcon,wisconsin_exoplanets-openai,wisconsin_exoplanets-openai10","1,6,5",0.4126984126984127,0.2900596423975445,0.543823156750429,63,26,0.5,0.37430716945155507,0.6256928305484449,66,33,9,15,24,16,17,18,13,17
"wisconsin_exoplanets-falcon,wisconsin_exoplanets-llamaphi,wisconsin_exoplanets-openailong","1,1,4",0.4126984126984127,0.2900596423975445,0.543823156750429,63,26,0.48484848484848486,0.3599107557499768,0.6111897347222226,66,32,9,15,24,17,17,17,13,17
"wisconsin_exoplanets-falcon10,wisconsin_exoplanets-openai10o1,wisconsin_exoplanets-phi","1,5,1",0.4126984126984127,0.2900596423975445,0.543823156750429,63,26,0.6515151515151515,0.5242397683271001,0.7647080305896783,66,43,16,28,31,19,10,15,6,4
"wisconsin_exoplanets-anthropic10,wisconsin_exoplanets-openai10o1,wisconsin_exoplanets-phi","1,5,1",0.3968253968253968,0.275691117775061,0.5279930536888335,63,25,0.5606060606060606,0.43296119670295957,0.6826341362307495,66,37,15,25,31,22,10,12,7,7
"wisconsin_exoplanets-falcon,wisconsin_exoplanets-openai10o1,wisconsin_exoplanets-openailong","1,5,4",0.3968253968253968,0.275691117775061,0.5279930536888335,63,25,0.45454545454545453,0.3314393816209253,0.5818631668533873,66,30,8,13,24,17,17,17,14,19
"wisconsin_exoplanets-anthropic10,wisconsin_exoplanets-llamaphi,wisconsin_exoplanets-qwq","1,1,1",0.3968253968253968,0.275691117775061,0.5279930536888335,63,25,0.4696969696969697,0.345621302763221,0.5965799465582751,66,31,13,21,29,24,12,10,9,11
"wisconsin_exoplanets-falcon,wisconsin_exoplanets-llamaphi,wisconsin_exoplanets-openai10","1,1,5",0.3968253968253968,0.275691117775061,0.5279930536888335,63,25,0.5,0.37430716945155507,0.6256928305484449,66,33,8,16,24,17,17,17,14,16
"wisconsin_exoplanets-falcon,wisconsin_exoplanets-openai10,wisconsin_exoplanets-openailong","1,5,4",0.3968253968253968,0.275691117775061,0.5279930536888335,63,25,0.48484848484848486,0.3599107557499768,0.6111897347222226,66,32,7,13,23,15,18,19,15,19
"wisconsin_exoplanets-falcon,wisconsin_exoplanets-llamaphi,wisconsin_exoplanets-openai45","1,1,4",0.3968253968253968,0.275691117775061,0.5279930536888335,63,25,0.5,0.37430716945155507,0.6256928305484449,66,33,9,15,25,16,16,18,13,17
"wisconsin_exoplanets-anthropic10,wisconsin_exoplanets-openai10,wisconsin_exoplanets-qwq","1,5,1",0.3968253968253968,0.275691117775061,0.5279930536888335,63,25,0.5303030303030303,0.403420053441725,0.654378697236779,66,35,13,23,29,22,12,12,9,9
"wisconsin_exoplanets-anthropic10,wisconsin_exoplanets-falcon,wisconsin_exoplanets-llamaphi","1,1,1",0.3968253968253968,0.275691117775061,0.5279930536888335,63,25,0.48484848484848486,0.3599107557499768,0.6111897347222226,66,32,14,22,30,24,11,10,8,10
"wisconsin_exoplanets-anthropic10,wisconsin_exoplanets-openai10o1,wisconsin_exoplanets-qwq","1,5,1",0.3968253968253968,0.275691117775061,0.5279930536888335,63,25,0.5151515151515151,0.3888102652777774,0.6400892442500232,66,34,14,22,30,22,11,12,8,10
"wisconsin_exoplanets-anthropic10,wisconsin_exoplanets-openailong,wisconsin_exoplanets-qwq","1,4,1",0.3968253968253968,0.275691117775061,0.5279930536888335,63,25,0.5303030303030303,0.403420053441725,0.654378697236779,66,35,13,23,29,22,12,12,9,9
"wisconsin_exoplanets-falcon,wisconsin_exoplanets-falcon10,wisconsin_exoplanets-openai45","1,1,4",0.3968253968253968,0.275691117775061,0.5279930536888335,63,25,0.5606060606060606,0.43296119670295957,0.6826341362307495,66,37,16,25,32,22,9,12,6,7
"wisconsin_exoplanets-anthropic10,wisconsin_exoplanets-falcon,wisconsin_exoplanets-phi","1,1,1",0.3968253968253968,0.275691117775061,0.5279930536888335,63,25,0.4393939393939394,0.31736586376925047,0.5670388032970404,66,29,9,14,25,19,16,15,13,18
"wisconsin_exoplanets-anthropic10,wisconsin_exoplanets-openai45,wisconsin_exoplanets-phi","1,4,1",0.3968253968253968,0.275691117775061,0.5279930536888335,63,25,0.5454545454545454,0.4181368331466126,0.6685606183790747,66,36,15,26,31,24,10,10,7,6
"wisconsin_exoplanets-falcon,wisconsin_exoplanets-falcon10,wisconsin_exoplanets-openailong","1,1,4",0.3968253968253968,0.275691117775061,0.5279930536888335,63,25,0.5454545454545454,0.4181368331466126,0.6685606183790747,66,36,16,25,32,23,9,11,6,7
"wisconsin_exoplanets-falcon,wisconsin_exoplanets-llamaphi,wisconsin_exoplanets-qwq","1,1,1",0.3968253968253968,0.275691117775061,0.5279930536888335,63,25,0.45454545454545453,0.3314393816209253,0.5818631668533873,66,30,11,17,27,21,14,13,11,15
"wisconsin_exoplanets-anthropic10,wisconsin_exoplanets-openai45,wisconsin_exoplanets-qwq","1,4,1",0.3968253968253968,0.275691117775061,0.5279930536888335,63,25,0.5303030303030303,0.403420053441725,0.654378697236779,66,35,14,23,30,22,11,12,8,9
"wisconsin_exoplanets-falcon,wisconsin_exoplanets-openai10,wisconsin_exoplanets-openai10o1","1,5,5",0.3968253968253968,0.275691117775061,0.5279930536888335,63,25,0.4696969696969697,0.345621302763221,0.5965799465582751,66,31,8,14,24,17,17,17,14,18
"wisconsin_exoplanets-falcon,wisconsin_exoplanets-openai10o1,wisconsin_exoplanets-openai45","1,5,4",0.38095238095238093,0.2614513102471425,0.5120366027993093,63,24,0.4696969696969697,0.345621302763221,0.5965799465582751,66,31,8,13,25,16,16,18,14,19
"wisconsin_exoplanets-falcon,wisconsin_exoplanets-falcon10,wisconsin_exoplanets-openai10o1","1,1,5",0.38095238095238093,0.2614513102471425,0.5120366027993093,63,24,0.5454545454545454,0.4181368331466126,0.6685606183790747,66,36,15,25,32,23,9,11,7,7
"wisconsin_exoplanets-falcon,wisconsin_exoplanets-falcon10,wisconsin_exoplanets-openai10","1,1,5",0.38095238095238093,0.2614513102471425,0.5120366027993093,63,24,0.5606060606060606,0.43296119670295957,0.6826341362307495,66,37,15,26,32,23,9,11,7,6
"wisconsin_exoplanets-anthropic10,wisconsin_exoplanets-openailong,wisconsin_exoplanets-phi","1,4,1",0.38095238095238093,0.2614513102471425,0.5120366027993093,63,24,0.5454545454545454,0.4181368331466126,0.6685606183790747,66,36,14,26,31,24,10,10,8,6
"wisconsin_exoplanets-anthropic10,wisconsin_exoplanets-falcon,wisconsin_exoplanets-openai45","1,1,4",0.36507936507936506,0.24734326467326245,0.49595122200495145,63,23,0.5303030303030303,0.403420053441725,0.654378697236779,66,35,14,23,32,22,9,12,8,9
"wisconsin_exoplanets-falcon,wisconsin_exoplanets-openai45,wisconsin_exoplanets-qwq","1,4,1",0.36507936507936506,0.24734326467326245,0.49595122200495145,63,23,0.4696969696969697,0.345621302763221,0.5965799465582751,66,31,12,18,30,21,11,13,10,14
"wisconsin_exoplanets-anthropic10,wisconsin_exoplanets-falcon,wisconsin_exoplanets-openailong","1,1,4",0.36507936507936506,0.24734326467326245,0.49595122200495145,63,23,0.5151515151515151,0.3888102652777774,0.6400892442500232,66,34,13,23,31,23,10,11,9,9
"wisconsin_exoplanets-anthropic10,wisconsin_exoplanets-openai10,wisconsin_exoplanets-phi","1,5,1",0.36507936507936506,0.24734326467326245,0.49595122200495145,63,23,0.5454545454545454,0.4181368331466126,0.6685606183790747,66,36,14,26,32,24,9,10,8,6
"wisconsin_exoplanets-anthropic10,wisconsin_exoplanets-falcon,wisconsin_exoplanets-qwq","1,1,1",0.36507936507936506,0.24734326467326245,0.49595122200495145,63,23,0.5,0.37430716945155507,0.6256928305484449,66,33,8,14,26,15,15,19,14,18
"wisconsin_exoplanets-falcon,wisconsin_exoplanets-openailong,wisconsin_exoplanets-qwq","1,4,1",0.36507936507936506,0.24734326467326245,0.49595122200495145,63,23,0.45454545454545453,0.3314393816209253,0.5818631668533873,66,30,12,18,30,22,11,12,10,14
"wisconsin_exoplanets-anthropic10,wisconsin_exoplanets-falcon,wisconsin_exoplanets-openai10","1,1,5",0.3492063492063492,0.23337058136700745,0.47973382291133443,63,22,0.5151515151515151,0.3888102652777774,0.6400892442500232,66,34,12,23,31,23,10,11,10,9
"wisconsin_exoplanets-falcon,wisconsin_exoplanets-openai10o1,wisconsin_exoplanets-qwq","1,5,1",0.3492063492063492,0.23337058136700745,0.47973382291133443,63,22,0.4696969696969697,0.345621302763221,0.5965799465582751,66,31,10,17,29,20,12,14,12,15
"wisconsin_exoplanets-falcon,wisconsin_exoplanets-openai10,wisconsin_exoplanets-qwq","1,5,1",0.3492063492063492,0.23337058136700745,0.47973382291133443,63,22,0.45454545454545453,0.3314393816209253,0.5818631668533873,66,30,11,18,30,22,11,12,11,14
"wisconsin_exoplanets-anthropic10,wisconsin_exoplanets-falcon,wisconsin_exoplanets-openai10o1","1,1,5",0.31746031746031744,0.205848902505895,0.4468877370931185,63,20,0.48484848484848486,0.3599107557499768,0.6111897347222226,66,32,12,21,33,23,8,11,10,11
